,Date,Total Approve,Total Disapprove,Total_Approve,Total_Disapprove,Relative_Approval,Neutral
0,2017-01-17,62%,38%,62,38,24,0
1,2017-01-16,62%,37%,62,37,25,1
2,2017-01-13,60%,38%,60,38,22,2
3,2017-01-12,61%,38%,61,38,23,1
4,2017-01-11,59%,39%,59,39,20,2
5,2017-01-10,60%,39%,60,39,21,1
6,2017-01-09,58%,40%,58,40,18,2
7,2017-01-06,58%,41%,58,41,17,1
8,2017-01-05,58%,41%,58,41,17,1
9,2017-01-04,57%,42%,57,42,15,1
10,2017-01-03,57%,42%,57,42,15,1
11,2016-12-30,55%,45%,55,45,10,0
12,2016-12-29,54%,46%,54,46,8,0
13,2016-12-28,55%,45%,55,45,10,0
14,2016-12-27,55%,44%,55,44,11,1
15,2016-12-23,56%,43%,56,43,13,1
16,2016-12-22,54%,44%,54,44,10,2
17,2016-12-21,54%,44%,54,44,10,2
18,2016-12-20,55%,44%,55,44,11,1
19,2016-12-19,57%,42%,57,42,15,1
20,2016-12-16,58%,40%,58,40,18,2
21,2016-12-15,58%,40%,58,40,18,2
22,2016-12-14,58%,41%,58,41,17,1
23,2016-12-13,57%,42%,57,42,15,1
24,2016-12-12,56%,43%,56,43,13,1
25,2016-12-09,56%,43%,56,43,13,1
26,2016-12-08,56%,43%,56,43,13,1
27,2016-12-07,56%,43%,56,43,13,1
28,2016-12-06,55%,43%,55,43,12,2
29,2016-12-05,54%,44%,54,44,10,2
30,2016-12-02,54%,45%,54,45,9,1
31,2016-12-01,54%,44%,54,44,10,2
32,2016-11-30,56%,43%,56,43,13,1
33,2016-11-29,55%,43%,55,43,12,2
34,2016-11-28,55%,43%,55,43,12,2
35,2016-11-23,53%,45%,53,45,8,2
36,2016-11-22,53%,45%,53,45,8,2
37,2016-11-21,53%,45%,53,45,8,2
38,2016-11-18,54%,45%,54,45,9,1
39,2016-11-17,54%,45%,54,45,9,1
40,2016-11-16,55%,44%,55,44,11,1
41,2016-11-15,55%,44%,55,44,11,1
42,2016-11-14,53%,45%,53,45,8,2
43,2016-11-11,54%,45%,54,45,9,1
44,2016-11-10,56%,43%,56,43,13,1
45,2016-11-09,56%,43%,56,43,13,1
46,2016-11-08,54%,45%,54,45,9,1
47,2016-11-07,52%,47%,52,47,5,1
48,2016-11-04,52%,46%,52,46,6,2
49,2016-11-03,52%,46%,52,46,6,2
50,2016-11-02,54%,45%,54,45,9,1
51,2016-11-01,53%,45%,53,45,8,2
52,2016-10-31,54%,44%,54,44,10,2
53,2016-10-28,54%,44%,54,44,10,2
54,2016-10-27,55%,44%,55,44,11,1
55,2016-10-26,55%,45%,55,45,10,0
56,2016-10-25,54%,44%,54,44,10,2
57,2016-10-24,52%,46%,52,46,6,2
58,2016-10-21,52%,46%,52,46,6,2
59,2016-10-20,49%,50%,49,50,-1,1
60,2016-10-19,50%,48%,50,48,2,2
61,2016-10-18,51%,48%,51,48,3,1
62,2016-10-17,51%,48%,51,48,3,1
63,2016-10-14,50%,49%,50,49,1,1
64,2016-10-13,50%,48%,50,48,2,2
65,2016-10-12,52%,46%,52,46,6,2
66,2016-10-11,52%,47%,52,47,5,1
67,2016-10-10,51%,48%,51,48,3,1
68,2016-10-07,49%,50%,49,50,-1,1
69,2016-10-06,50%,50%,50,50,0,0
70,2016-10-05,50%,49%,50,49,1,1
71,2016-10-04,50%,49%,50,49,1,1
72,2016-10-03,52%,48%,52,48,4,0
73,2016-09-30,50%,49%,50,49,1,1
74,2016-09-29,51%,47%,51,47,4,2
75,2016-09-28,50%,48%,50,48,2,2
76,2016-09-27,48%,51%,48,51,-3,1
77,2016-09-26,47%,52%,47,52,-5,1
78,2016-09-23,47%,52%,47,52,-5,1
79,2016-09-22,48%,51%,48,51,-3,1
80,2016-09-21,48%,52%,48,52,-4,0
81,2016-09-20,47%,52%,47,52,-5,1
82,2016-09-19,47%,52%,47,52,-5,1
83,2016-09-16,49%,51%,49,51,-2,0
84,2016-09-15,50%,49%,50,49,1,1
85,2016-09-14,51%,48%,51,48,3,1
86,2016-09-13,51%,48%,51,48,3,1
87,2016-09-12,51%,48%,51,48,3,1
88,2016-09-09,51%,48%,51,48,3,1
89,2016-09-08,51%,48%,51,48,3,1
90,2016-09-07,51%,48%,51,48,3,1
91,2016-09-06,50%,49%,50,49,1,1
92,2016-09-05,50%,49%,50,49,1,1
93,2016-09-02,49%,50%,49,50,-1,1
94,2016-09-01,49%,50%,49,50,-1,1
95,2016-08-31,48%,50%,48,50,-2,2
96,2016-08-30,49%,50%,49,50,-1,1
97,2016-08-29,50%,49%,50,49,1,1
98,2016-08-26,50%,49%,50,49,1,1
99,2016-08-25,50%,48%,50,48,2,2
100,2016-08-24,52%,47%,52,47,5,1
101,2016-08-23,52%,47%,52,47,5,1
102,2016-08-22,50%,49%,50,49,1,1
103,2016-08-19,50%,49%,50,49,1,1
104,2016-08-18,51%,48%,51,48,3,1
105,2016-08-17,52%,48%,52,48,4,0
106,2016-08-16,51%,49%,51,49,2,0
107,2016-08-15,51%,48%,51,48,3,1
108,2016-08-12,51%,48%,51,48,3,1
109,2016-08-11,52%,47%,52,47,5,1
110,2016-08-10,51%,49%,51,49,2,0
111,2016-08-09,49%,51%,49,51,-2,0
112,2016-08-08,48%,51%,48,51,-3,1
113,2016-08-05,48%,51%,48,51,-3,1
114,2016-08-04,51%,48%,51,48,3,1
115,2016-08-03,53%,46%,53,46,7,1
116,2016-08-02,53%,46%,53,46,7,1
117,2016-08-01,52%,46%,52,46,6,2
118,2016-07-29,50%,49%,50,49,1,1
119,2016-07-28,51%,48%,51,48,3,1
120,2016-07-27,50%,49%,50,49,1,1
121,2016-07-26,48%,50%,48,50,-2,2
122,2016-07-25,46%,53%,46,53,-7,1
123,2016-07-22,49%,50%,49,50,-1,1
124,2016-07-21,51%,48%,51,48,3,1
125,2016-07-20,51%,48%,51,48,3,1
126,2016-07-19,49%,50%,49,50,-1,1
127,2016-07-18,48%,51%,48,51,-3,1
128,2016-07-15,46%,52%,46,52,-6,2
129,2016-07-14,46%,53%,46,53,-7,1
130,2016-07-13,47%,52%,47,52,-5,1
131,2016-07-12,48%,51%,48,51,-3,1
132,2016-07-11,48%,51%,48,51,-3,1
133,2016-07-08,49%,50%,49,50,-1,1
134,2016-07-07,49%,50%,49,50,-1,1
135,2016-07-06,50%,49%,50,49,1,1
136,2016-07-04,51%,48%,51,48,3,1
137,2016-07-01,50%,48%,50,48,2,2
138,2016-06-30,50%,49%,50,49,1,1
139,2016-06-29,51%,48%,51,48,3,1
140,2016-06-28,52%,48%,52,48,4,0
141,2016-06-27,50%,49%,50,49,1,1
142,2016-06-24,50%,49%,50,49,1,1
143,2016-06-23,50%,49%,50,49,1,1
144,2016-06-22,51%,48%,51,48,3,1
145,2016-06-21,49%,50%,49,50,-1,1
146,2016-06-20,50%,49%,50,49,1,1
147,2016-06-17,50%,49%,50,49,1,1
148,2016-06-16,50%,49%,50,49,1,1
149,2016-06-15,48%,50%,48,50,-2,2
150,2016-06-14,49%,50%,49,50,-1,1
151,2016-06-13,49%,50%,49,50,-1,1
152,2016-06-10,49%,49%,49,49,0,2
153,2016-06-09,49%,50%,49,50,-1,1
154,2016-06-08,50%,49%,50,49,1,1
155,2016-06-07,51%,48%,51,48,3,1
156,2016-06-06,52%,46%,52,46,6,2
157,2016-06-03,52%,46%,52,46,6,2
158,2016-06-02,51%,48%,51,48,3,1
159,2016-06-01,51%,47%,51,47,4,2
160,2016-05-31,50%,48%,50,48,2,2
161,2016-05-30,50%,48%,50,48,2,2
162,2016-05-27,51%,48%,51,48,3,1
163,2016-05-26,51%,48%,51,48,3,1
164,2016-05-25,50%,49%,50,49,1,1
165,2016-05-24,49%,50%,49,50,-1,1
166,2016-05-23,50%,50%,50,50,0,0
167,2016-05-20,49%,50%,49,50,-1,1
168,2016-05-19,50%,49%,50,49,1,1
169,2016-05-18,49%,50%,49,50,-1,1
170,2016-05-17,49%,50%,49,50,-1,1
171,2016-05-16,49%,50%,49,50,-1,1
172,2016-05-13,50%,49%,50,49,1,1
173,2016-05-12,49%,49%,49,49,0,2
174,2016-05-11,50%,49%,50,49,1,1
175,2016-05-10,50%,49%,50,49,1,1
176,2016-05-09,50%,49%,50,49,1,1
177,2016-05-06,49%,50%,49,50,-1,1
178,2016-05-05,49%,50%,49,50,-1,1
179,2016-05-04,50%,49%,50,49,1,1
180,2016-05-03,50%,49%,50,49,1,1
181,2016-05-02,51%,48%,51,48,3,1
182,2016-04-29,50%,48%,50,48,2,2
183,2016-04-28,49%,50%,49,50,-1,1
184,2016-04-27,51%,48%,51,48,3,1
185,2016-04-26,51%,48%,51,48,3,1
186,2016-04-25,52%,47%,52,47,5,1
187,2016-04-22,51%,48%,51,48,3,1
188,2016-04-21,49%,50%,49,50,-1,1
189,2016-04-20,48%,50%,48,50,-2,2
190,2016-04-19,47%,51%,47,51,-4,2
191,2016-04-18,49%,50%,49,50,-1,1
192,2016-04-15,49%,51%,49,51,-2,0
193,2016-04-14,48%,51%,48,51,-3,1
194,2016-04-13,49%,50%,49,50,-1,1
195,2016-04-12,51%,48%,51,48,3,1
196,2016-04-11,52%,46%,52,46,6,2
197,2016-04-08,52%,46%,52,46,6,2
198,2016-04-07,50%,49%,50,49,1,1
199,2016-04-06,50%,50%,50,50,0,0
200,2016-04-05,48%,51%,48,51,-3,1
201,2016-04-04,48%,51%,48,51,-3,1
202,2016-04-01,49%,50%,49,50,-1,1
203,2016-03-31,52%,47%,52,47,5,1
204,2016-03-30,51%,48%,51,48,3,1
205,2016-03-29,49%,50%,49,50,-1,1
206,2016-03-28,49%,50%,49,50,-1,1
207,2016-03-25,49%,50%,49,50,-1,1
208,2016-03-24,50%,49%,50,49,1,1
209,2016-03-23,50%,50%,50,50,0,0
210,2016-03-22,52%,48%,52,48,4,0
211,2016-03-21,52%,47%,52,47,5,1
212,2016-03-18,51%,47%,51,47,4,2
213,2016-03-17,50%,49%,50,49,1,1
214,2016-03-16,51%,49%,51,49,2,0
215,2016-03-15,50%,50%,50,50,0,0
216,2016-03-14,51%,49%,51,49,2,0
217,2016-03-11,50%,50%,50,50,0,0
218,2016-03-10,50%,49%,50,49,1,1
219,2016-03-09,47%,51%,47,51,-4,2
220,2016-03-08,47%,51%,47,51,-4,2
221,2016-03-07,47%,52%,47,52,-5,1
222,2016-03-04,48%,51%,48,51,-3,1
223,2016-03-03,47%,51%,47,51,-4,2
224,2016-03-02,50%,49%,50,49,1,1
225,2016-03-01,50%,49%,50,49,1,1
226,2016-02-29,50%,50%,50,50,0,0
227,2016-02-26,48%,51%,48,51,-3,1
228,2016-02-25,50%,49%,50,49,1,1
229,2016-02-24,51%,48%,51,48,3,1
230,2016-02-23,51%,48%,51,48,3,1
231,2016-02-22,50%,49%,50,49,1,1
232,2016-02-19,49%,50%,49,50,-1,1
233,2016-02-18,49%,50%,49,50,-1,1
234,2016-02-17,49%,50%,49,50,-1,1
235,2016-02-16,48%,51%,48,51,-3,1
236,2016-02-15,47%,52%,47,52,-5,1
237,2016-02-12,47%,52%,47,52,-5,1
238,2016-02-11,47%,52%,47,52,-5,1
239,2016-02-10,47%,53%,47,53,-6,0
240,2016-02-09,48%,51%,48,51,-3,1
241,2016-02-08,49%,50%,49,50,-1,1
242,2016-02-05,49%,50%,49,50,-1,1
243,2016-02-04,48%,51%,48,51,-3,1
244,2016-02-03,47%,52%,47,52,-5,1
245,2016-02-02,47%,51%,47,51,-4,2
246,2016-02-01,48%,51%,48,51,-3,1
247,2016-01-29,49%,50%,49,50,-1,1
248,2016-01-28,50%,49%,50,49,1,1
249,2016-01-27,50%,49%,50,49,1,1
250,2016-01-26,50%,49%,50,49,1,1
251,2016-01-25,49%,50%,49,50,-1,1
252,2016-01-22,49%,50%,49,50,-1,1
253,2016-01-21,48%,51%,48,51,-3,1
254,2016-01-20,50%,49%,50,49,1,1
255,2016-01-19,49%,50%,49,50,-1,1
256,2016-01-18,49%,50%,49,50,-1,1
257,2016-01-15,47%,52%,47,52,-5,1
258,2016-01-14,48%,50%,48,50,-2,2
259,2016-01-13,47%,51%,47,51,-4,2
260,2016-01-12,48%,51%,48,51,-3,1
261,2016-01-11,46%,53%,46,53,-7,1
262,2016-01-08,46%,53%,46,53,-7,1
263,2016-01-07,46%,53%,46,53,-7,1
264,2016-01-06,48%,52%,48,52,-4,0
265,2016-01-05,49%,50%,49,50,-1,1
266,2016-01-04,48%,51%,48,51,-3,1
267,2015-12-31,46%,52%,46,52,-6,2
268,2015-12-30,45%,54%,45,54,-9,1
269,2015-12-29,45%,53%,45,53,-8,2
270,2015-12-28,46%,53%,46,53,-7,1
271,2015-12-24,46%,52%,46,52,-6,2
272,2015-12-23,47%,53%,47,53,-6,0
273,2015-12-22,47%,52%,47,52,-5,1
274,2015-12-21,46%,52%,46,52,-6,2
275,2015-12-18,46%,53%,46,53,-7,1
276,2015-12-17,46%,52%,46,52,-6,2
277,2015-12-16,46%,53%,46,53,-7,1
278,2015-12-15,46%,52%,46,52,-6,2
279,2015-12-14,46%,53%,46,53,-7,1
280,2015-12-11,47%,52%,47,52,-5,1
281,2015-12-10,46%,53%,46,53,-7,1
282,2015-12-09,45%,54%,45,54,-9,1
283,2015-12-08,43%,55%,43,55,-12,2
284,2015-12-07,45%,54%,45,54,-9,1
285,2015-12-04,45%,54%,45,54,-9,1
286,2015-12-03,47%,52%,47,52,-5,1
287,2015-12-02,48%,51%,48,51,-3,1
288,2015-12-01,49%,50%,49,50,-1,1
289,2015-11-30,50%,49%,50,49,1,1
290,2015-11-25,47%,52%,47,52,-5,1
291,2015-11-24,45%,54%,45,54,-9,1
292,2015-11-23,43%,56%,43,56,-13,1
293,2015-11-20,43%,55%,43,55,-12,2
294,2015-11-19,44%,54%,44,54,-10,2
295,2015-11-18,44%,55%,44,55,-11,1
296,2015-11-17,44%,54%,44,54,-10,2
297,2015-11-16,44%,54%,44,54,-10,2
298,2015-11-13,46%,53%,46,53,-7,1
299,2015-11-12,47%,52%,47,52,-5,1
300,2015-11-11,48%,51%,48,51,-3,1
301,2015-11-10,48%,51%,48,51,-3,1
302,2015-11-09,45%,54%,45,54,-9,1
303,2015-11-06,45%,54%,45,54,-9,1
304,2015-11-05,44%,55%,44,55,-11,1
305,2015-11-04,46%,52%,46,52,-6,2
306,2015-11-03,46%,52%,46,52,-6,2
307,2015-11-02,49%,49%,49,49,0,2
308,2015-10-30,51%,48%,51,48,3,1
309,2015-10-29,50%,48%,50,48,2,2
310,2015-10-28,46%,52%,46,52,-6,2
311,2015-10-27,45%,53%,45,53,-8,2
312,2015-10-26,46%,53%,46,53,-7,1
313,2015-10-23,48%,51%,48,51,-3,1
314,2015-10-22,48%,51%,48,51,-3,1
315,2015-10-21,47%,52%,47,52,-5,1
316,2015-10-20,46%,52%,46,52,-6,2
317,2015-10-19,46%,53%,46,53,-7,1
318,2015-10-16,46%,53%,46,53,-7,1
319,2015-10-15,46%,52%,46,52,-6,2
320,2015-10-14,45%,54%,45,54,-9,1
321,2015-10-13,46%,53%,46,53,-7,1
322,2015-10-12,45%,55%,45,55,-10,0
323,2015-10-09,47%,52%,47,52,-5,1
324,2015-10-08,46%,54%,46,54,-8,0
325,2015-10-07,47%,53%,47,53,-6,0
326,2015-10-06,46%,53%,46,53,-7,1
327,2015-10-05,47%,52%,47,52,-5,1
328,2015-10-02,48%,51%,48,51,-3,1
329,2015-10-01,47%,52%,47,52,-5,1
330,2015-09-30,46%,53%,46,53,-7,1
331,2015-09-29,46%,53%,46,53,-7,1
332,2015-09-28,47%,52%,47,52,-5,1
333,2015-09-25,49%,51%,49,51,-2,0
334,2015-09-24,46%,53%,46,53,-7,1
335,2015-09-23,46%,52%,46,52,-6,2
336,2015-09-22,45%,54%,45,54,-9,1
337,2015-09-21,46%,52%,46,52,-6,2
338,2015-09-18,45%,54%,45,54,-9,1
339,2015-09-17,44%,55%,44,55,-11,1
340,2015-09-16,44%,55%,44,55,-11,1
341,2015-09-15,46%,53%,46,53,-7,1
342,2015-09-14,51%,47%,51,47,4,2
343,2015-09-11,50%,48%,50,48,2,2
344,2015-09-10,49%,50%,49,50,-1,1
345,2015-09-09,46%,53%,46,53,-7,1
346,2015-09-08,44%,55%,44,55,-11,1
347,2015-09-07,45%,54%,45,54,-9,1
348,2015-09-04,45%,54%,45,54,-9,1
349,2015-09-03,47%,52%,47,52,-5,1
350,2015-09-02,47%,53%,47,53,-6,0
351,2015-09-01,47%,53%,47,53,-6,0
352,2015-08-31,46%,53%,46,53,-7,1
353,2015-08-28,46%,53%,46,53,-7,1
354,2015-08-27,47%,52%,47,52,-5,1
355,2015-08-26,47%,51%,47,51,-4,2
356,2015-08-25,48%,51%,48,51,-3,1
357,2015-08-24,45%,54%,45,54,-9,1
358,2015-08-21,44%,54%,44,54,-10,2
359,2015-08-20,43%,55%,43,55,-12,2
360,2015-08-19,45%,52%,45,52,-7,3
361,2015-08-18,46%,52%,46,52,-6,2
362,2015-08-17,47%,51%,47,51,-4,2
363,2015-08-14,47%,52%,47,52,-5,1
364,2015-08-13,47%,52%,47,52,-5,1
365,2015-08-12,47%,52%,47,52,-5,1
366,2015-08-11,47%,52%,47,52,-5,1
367,2015-08-10,47%,51%,47,51,-4,2
368,2015-08-07,47%,52%,47,52,-5,1
369,2015-08-06,47%,52%,47,52,-5,1
370,2015-08-05,45%,53%,45,53,-8,2
371,2015-08-04,45%,53%,45,53,-8,2
372,2015-08-03,46%,52%,46,52,-6,2
373,2015-07-31,46%,52%,46,52,-6,2
374,2015-07-30,47%,51%,47,51,-4,2
375,2015-07-29,48%,50%,48,50,-2,2
376,2015-07-28,46%,52%,46,52,-6,2
377,2015-07-27,46%,53%,46,53,-7,1
378,2015-07-24,46%,53%,46,53,-7,1
379,2015-07-23,47%,52%,47,52,-5,1
380,2015-07-22,46%,53%,46,53,-7,1
381,2015-07-21,46%,53%,46,53,-7,1
382,2015-07-20,45%,55%,45,55,-10,0
383,2015-07-17,45%,54%,45,54,-9,1
384,2015-07-16,45%,54%,45,54,-9,1
385,2015-07-15,48%,51%,48,51,-3,1
386,2015-07-14,47%,52%,47,52,-5,1
387,2015-07-13,48%,51%,48,51,-3,1
388,2015-07-10,47%,52%,47,52,-5,1
389,2015-07-09,48%,51%,48,51,-3,1
390,2015-07-08,48%,51%,48,51,-3,1
391,2015-07-07,48%,51%,48,51,-3,1
392,2015-07-06,48%,52%,48,52,-4,0
393,2015-07-03,48%,51%,48,51,-3,1
394,2015-07-02,48%,51%,48,51,-3,1
395,2015-07-01,49%,50%,49,50,-1,1
396,2015-06-30,48%,50%,48,50,-2,2
397,2015-06-29,48%,51%,48,51,-3,1
398,2015-06-26,45%,53%,45,53,-8,2
399,2015-06-25,44%,54%,44,54,-10,2
400,2015-06-24,45%,53%,45,53,-8,2
401,2015-06-23,46%,52%,46,52,-6,2
402,2015-06-22,47%,52%,47,52,-5,1
403,2015-06-19,45%,54%,45,54,-9,1
404,2015-06-18,45%,54%,45,54,-9,1
405,2015-06-17,46%,53%,46,53,-7,1
406,2015-06-16,47%,52%,47,52,-5,1
407,2015-06-15,46%,52%,46,52,-6,2
408,2015-06-12,45%,53%,45,53,-8,2
409,2015-06-11,47%,52%,47,52,-5,1
410,2015-06-10,48%,50%,48,50,-2,2
411,2015-06-09,49%,49%,49,49,0,2
412,2015-06-08,48%,50%,48,50,-2,2
413,2015-06-05,47%,51%,47,51,-4,2
414,2015-06-04,47%,51%,47,51,-4,2
415,2015-06-03,47%,52%,47,52,-5,1
416,2015-06-02,46%,52%,46,52,-6,2
417,2015-06-01,48%,51%,48,51,-3,1
418,2015-05-29,47%,51%,47,51,-4,2
419,2015-05-28,47%,52%,47,52,-5,1
420,2015-05-27,46%,53%,46,53,-7,1
421,2015-05-26,46%,53%,46,53,-7,1
422,2015-05-25,46%,52%,46,52,-6,2
423,2015-05-22,46%,53%,46,53,-7,1
424,2015-05-21,46%,53%,46,53,-7,1
425,2015-05-20,46%,53%,46,53,-7,1
426,2015-05-19,47%,51%,47,51,-4,2
427,2015-05-18,46%,53%,46,53,-7,1
428,2015-05-15,47%,52%,47,52,-5,1
429,2015-05-14,46%,53%,46,53,-7,1
430,2015-05-13,48%,51%,48,51,-3,1
431,2015-05-12,47%,52%,47,52,-5,1
432,2015-05-11,47%,52%,47,52,-5,1
433,2015-05-08,45%,53%,45,53,-8,2
434,2015-05-07,47%,51%,47,51,-4,2
435,2015-05-06,49%,50%,49,50,-1,1
436,2015-05-05,48%,51%,48,51,-3,1
437,2015-05-04,47%,51%,47,51,-4,2
438,2015-05-01,48%,51%,48,51,-3,1
439,2015-04-30,48%,50%,48,50,-2,2
440,2015-04-29,46%,52%,46,52,-6,2
441,2015-04-28,46%,53%,46,53,-7,1
442,2015-04-27,44%,55%,44,55,-11,1
443,2015-04-24,46%,53%,46,53,-7,1
444,2015-04-23,45%,53%,45,53,-8,2
445,2015-04-22,47%,52%,47,52,-5,1
446,2015-04-21,46%,53%,46,53,-7,1
447,2015-04-20,46%,52%,46,52,-6,2
448,2015-04-17,46%,53%,46,53,-7,1
449,2015-04-16,47%,51%,47,51,-4,2
450,2015-04-15,48%,50%,48,50,-2,2
451,2015-04-14,49%,49%,49,49,0,2
452,2015-04-13,48%,50%,48,50,-2,2
453,2015-04-10,47%,52%,47,52,-5,1
454,2015-04-09,47%,51%,47,51,-4,2
455,2015-04-08,47%,51%,47,51,-4,2
456,2015-04-07,47%,51%,47,51,-4,2
457,2015-04-06,47%,51%,47,51,-4,2
458,2015-04-03,47%,52%,47,52,-5,1
459,2015-04-02,47%,51%,47,51,-4,2
460,2015-04-01,48%,50%,48,50,-2,2
461,2015-03-31,48%,50%,48,50,-2,2
462,2015-03-30,48%,51%,48,51,-3,1
463,2015-03-27,47%,52%,47,52,-5,1
464,2015-03-26,46%,54%,46,54,-8,0
465,2015-03-25,48%,51%,48,51,-3,1
466,2015-03-24,47%,52%,47,52,-5,1
467,2015-03-23,48%,50%,48,50,-2,2
468,2015-03-20,46%,53%,46,53,-7,1
469,2015-03-19,47%,52%,47,52,-5,1
470,2015-03-18,47%,52%,47,52,-5,1
471,2015-03-17,48%,50%,48,50,-2,2
472,2015-03-16,48%,51%,48,51,-3,1
473,2015-03-13,49%,50%,49,50,-1,1
474,2015-03-12,49%,50%,49,50,-1,1
475,2015-03-11,50%,48%,50,48,2,2
476,2015-03-10,49%,50%,49,50,-1,1
477,2015-03-09,47%,51%,47,51,-4,2
478,2015-03-06,46%,52%,46,52,-6,2
479,2015-03-05,47%,52%,47,52,-5,1
480,2015-03-04,48%,51%,48,51,-3,1
481,2015-03-03,49%,50%,49,50,-1,1
482,2015-03-02,49%,49%,49,49,0,2
483,2015-03-01,48%,51%,48,51,-3,1
484,2015-02-28,47%,52%,47,52,-5,1
485,2015-02-27,47%,52%,47,52,-5,1
486,2015-02-26,47%,51%,47,51,-4,2
487,2015-02-25,49%,49%,49,49,0,2
488,2015-02-24,48%,50%,48,50,-2,2
489,2015-02-23,49%,50%,49,50,-1,1
490,2015-02-22,50%,49%,50,49,1,1
491,2015-02-21,51%,48%,51,48,3,1
492,2015-02-20,49%,50%,49,50,-1,1
493,2015-02-19,47%,52%,47,52,-5,1
494,2015-02-18,49%,50%,49,50,-1,1
495,2015-02-17,49%,49%,49,49,0,2
496,2015-02-16,50%,48%,50,48,2,2
497,2015-02-15,49%,49%,49,49,0,2
498,2015-02-14,47%,51%,47,51,-4,2
499,2015-02-13,46%,53%,46,53,-7,1
500,2015-02-12,46%,52%,46,52,-6,2
501,2015-02-11,46%,52%,46,52,-6,2
502,2015-02-10,49%,50%,49,50,-1,1
503,2015-02-09,49%,50%,49,50,-1,1
504,2015-02-08,50%,49%,50,49,1,1
505,2015-02-07,48%,50%,48,50,-2,2
506,2015-02-06,48%,50%,48,50,-2,2
507,2015-02-05,50%,48%,50,48,2,2
508,2015-02-04,51%,48%,51,48,3,1
509,2015-02-03,50%,49%,50,49,1,1
510,2015-02-02,51%,48%,51,48,3,1
511,2015-02-01,51%,47%,51,47,4,2
512,2015-01-31,51%,47%,51,47,4,2
513,2015-01-30,50%,48%,50,48,2,2
514,2015-01-29,50%,49%,50,49,1,1
515,2015-01-28,48%,51%,48,51,-3,1
516,2015-01-27,47%,51%,47,51,-4,2
517,2015-01-26,48%,51%,48,51,-3,1
518,2015-01-25,50%,48%,50,48,2,2
519,2015-01-24,52%,47%,52,47,5,1
520,2015-01-23,51%,47%,51,47,4,2
521,2015-01-22,50%,48%,50,48,2,2
522,2015-01-21,49%,50%,49,50,-1,1
523,2015-01-20,48%,51%,48,51,-3,1
524,2015-01-19,49%,50%,49,50,-1,1
525,2015-01-18,49%,50%,49,50,-1,1
526,2015-01-17,49%,49%,49,49,0,2
527,2015-01-16,48%,50%,48,50,-2,2
528,2015-01-15,48%,50%,48,50,-2,2
529,2015-01-14,50%,49%,50,49,1,1
530,2015-01-13,49%,50%,49,50,-1,1
531,2015-01-12,49%,50%,49,50,-1,1
532,2015-01-11,48%,51%,48,51,-3,1
533,2015-01-10,47%,52%,47,52,-5,1
534,2015-01-09,48%,50%,48,50,-2,2
535,2015-01-08,48%,50%,48,50,-2,2
536,2015-01-07,51%,47%,51,47,4,2
537,2015-01-06,51%,48%,51,48,3,1
538,2015-01-05,51%,48%,51,48,3,1
539,2015-01-04,50%,48%,50,48,2,2
540,2015-01-03,50%,48%,50,48,2,2
541,2014-12-31,49%,49%,49,49,0,2
542,2014-12-30,48%,50%,48,50,-2,2
543,2014-12-29,48%,51%,48,51,-3,1
544,2014-12-24,48%,51%,48,51,-3,1
545,2014-12-23,48%,51%,48,51,-3,1
546,2014-12-22,47%,52%,47,52,-5,1
547,2014-12-21,48%,51%,48,51,-3,1
548,2014-12-20,47%,52%,47,52,-5,1
549,2014-12-19,47%,51%,47,51,-4,2
550,2014-12-18,47%,51%,47,51,-4,2
551,2014-12-17,47%,51%,47,51,-4,2
552,2014-12-16,47%,51%,47,51,-4,2
553,2014-12-15,48%,51%,48,51,-3,1
554,2014-12-14,48%,50%,48,50,-2,2
555,2014-12-13,48%,50%,48,50,-2,2
556,2014-12-12,47%,51%,47,51,-4,2
557,2014-12-11,47%,52%,47,52,-5,1
558,2014-12-10,48%,50%,48,50,-2,2
559,2014-12-09,49%,50%,49,50,-1,1
560,2014-12-08,50%,49%,50,49,1,1
561,2014-12-07,47%,52%,47,52,-5,1
562,2014-12-06,46%,52%,46,52,-6,2
563,2014-12-05,46%,52%,46,52,-6,2
564,2014-12-04,47%,51%,47,51,-4,2
565,2014-12-03,48%,50%,48,50,-2,2
566,2014-12-02,48%,51%,48,51,-3,1
567,2014-12-01,48%,50%,48,50,-2,2
568,2014-11-26,46%,52%,46,52,-6,2
569,2014-11-25,45%,52%,45,52,-7,3
570,2014-11-24,45%,53%,45,53,-8,2
571,2014-11-23,47%,51%,47,51,-4,2
572,2014-11-22,47%,52%,47,52,-5,1
573,2014-11-21,47%,52%,47,52,-5,1
574,2014-11-20,46%,53%,46,53,-7,1
575,2014-11-19,48%,50%,48,50,-2,2
576,2014-11-18,48%,51%,48,51,-3,1
577,2014-11-17,48%,50%,48,50,-2,2
578,2014-11-16,46%,52%,46,52,-6,2
579,2014-11-15,48%,51%,48,51,-3,1
580,2014-11-14,48%,50%,48,50,-2,2
581,2014-11-13,48%,51%,48,51,-3,1
582,2014-11-12,47%,52%,47,52,-5,1
583,2014-11-11,48%,51%,48,51,-3,1
584,2014-11-10,48%,50%,48,50,-2,2
585,2014-11-09,48%,50%,48,50,-2,2
586,2014-11-08,48%,51%,48,51,-3,1
587,2014-11-07,48%,51%,48,51,-3,1
588,2014-11-06,46%,52%,46,52,-6,2
589,2014-11-05,46%,52%,46,52,-6,2
590,2014-11-04,45%,53%,45,53,-8,2
591,2014-11-03,45%,53%,45,53,-8,2
592,2014-11-02,45%,53%,45,53,-8,2
593,2014-11-01,46%,52%,46,52,-6,2
594,2014-10-31,47%,52%,47,52,-5,1
595,2014-10-30,46%,53%,46,53,-7,1
596,2014-10-29,46%,53%,46,53,-7,1
597,2014-10-28,45%,53%,45,53,-8,2
598,2014-10-27,46%,53%,46,53,-7,1
599,2014-10-26,46%,53%,46,53,-7,1
600,2014-10-25,47%,52%,47,52,-5,1
601,2014-10-24,47%,52%,47,52,-5,1
602,2014-10-23,48%,51%,48,51,-3,1
603,2014-10-22,47%,52%,47,52,-5,1
604,2014-10-21,47%,52%,47,52,-5,1
605,2014-10-20,46%,52%,46,52,-6,2
606,2014-10-19,47%,51%,47,51,-4,2
607,2014-10-18,48%,51%,48,51,-3,1
608,2014-10-17,47%,51%,47,51,-4,2
609,2014-10-16,48%,50%,48,50,-2,2
610,2014-10-15,49%,49%,49,49,0,2
611,2014-10-14,49%,49%,49,49,0,2
612,2014-10-13,48%,50%,48,50,-2,2
613,2014-10-12,47%,51%,47,51,-4,2
614,2014-10-11,47%,52%,47,52,-5,1
615,2014-10-10,46%,52%,46,52,-6,2
616,2014-10-09,46%,52%,46,52,-6,2
617,2014-10-08,46%,52%,46,52,-6,2
618,2014-10-07,46%,52%,46,52,-6,2
619,2014-10-06,48%,51%,48,51,-3,1
620,2014-10-05,47%,51%,47,51,-4,2
621,2014-10-04,48%,51%,48,51,-3,1
622,2014-10-03,48%,51%,48,51,-3,1
623,2014-10-02,48%,51%,48,51,-3,1
624,2014-10-01,48%,50%,48,50,-2,2
625,2014-09-30,48%,50%,48,50,-2,2
626,2014-09-29,46%,52%,46,52,-6,2
627,2014-09-28,47%,51%,47,51,-4,2
628,2014-09-27,47%,52%,47,52,-5,1
629,2014-09-26,47%,51%,47,51,-4,2
630,2014-09-25,47%,52%,47,52,-5,1
631,2014-09-24,46%,52%,46,52,-6,2
632,2014-09-23,47%,52%,47,52,-5,1
633,2014-09-22,47%,52%,47,52,-5,1
634,2014-09-21,46%,53%,46,53,-7,1
635,2014-09-20,47%,52%,47,52,-5,1
636,2014-09-19,46%,53%,46,53,-7,1
637,2014-09-18,46%,53%,46,53,-7,1
638,2014-09-17,45%,54%,45,54,-9,1
639,2014-09-16,47%,53%,47,53,-6,0
640,2014-09-15,48%,51%,48,51,-3,1
641,2014-09-14,49%,50%,49,50,-1,1
642,2014-09-13,48%,51%,48,51,-3,1
643,2014-09-12,48%,51%,48,51,-3,1
644,2014-09-11,48%,51%,48,51,-3,1
645,2014-09-10,47%,51%,47,51,-4,2
646,2014-09-09,46%,52%,46,52,-6,2
647,2014-09-08,46%,53%,46,53,-7,1
648,2014-09-07,46%,53%,46,53,-7,1
649,2014-09-06,47%,51%,47,51,-4,2
650,2014-09-05,47%,51%,47,51,-4,2
651,2014-09-04,47%,51%,47,51,-4,2
652,2014-09-03,46%,52%,46,52,-6,2
653,2014-09-02,46%,52%,46,52,-6,2
654,2014-09-01,46%,52%,46,52,-6,2
655,2014-08-31,46%,52%,46,52,-6,2
656,2014-08-30,47%,52%,47,52,-5,1
657,2014-08-29,46%,52%,46,52,-6,2
658,2014-08-28,46%,52%,46,52,-6,2
659,2014-08-27,46%,53%,46,53,-7,1
660,2014-08-26,45%,53%,45,53,-8,2
661,2014-08-25,44%,54%,44,54,-10,2
662,2014-08-24,43%,56%,43,56,-13,1
663,2014-08-23,45%,53%,45,53,-8,2
664,2014-08-22,45%,53%,45,53,-8,2
665,2014-08-21,46%,53%,46,53,-7,1
666,2014-08-20,46%,53%,46,53,-7,1
667,2014-08-19,47%,52%,47,52,-5,1
668,2014-08-18,48%,51%,48,51,-3,1
669,2014-08-17,46%,52%,46,52,-6,2
670,2014-08-16,46%,52%,46,52,-6,2
671,2014-08-15,45%,53%,45,53,-8,2
672,2014-08-14,45%,53%,45,53,-8,2
673,2014-08-13,46%,53%,46,53,-7,1
674,2014-08-12,47%,52%,47,52,-5,1
675,2014-08-11,45%,53%,45,53,-8,2
676,2014-08-10,44%,54%,44,54,-10,2
677,2014-08-09,44%,55%,44,55,-11,1
678,2014-08-08,46%,53%,46,53,-7,1
679,2014-08-07,48%,51%,48,51,-3,1
680,2014-08-06,47%,52%,47,52,-5,1
681,2014-08-05,47%,52%,47,52,-5,1
682,2014-08-04,46%,53%,46,53,-7,1
683,2014-08-03,46%,53%,46,53,-7,1
684,2014-08-02,45%,53%,45,53,-8,2
685,2014-08-01,45%,54%,45,54,-9,1
686,2014-07-31,45%,53%,45,53,-8,2
687,2014-07-30,46%,54%,46,54,-8,0
688,2014-07-29,47%,52%,47,52,-5,1
689,2014-07-28,45%,53%,45,53,-8,2
690,2014-07-27,46%,52%,46,52,-6,2
691,2014-07-26,44%,54%,44,54,-10,2
692,2014-07-25,46%,52%,46,52,-6,2
693,2014-07-24,46%,52%,46,52,-6,2
694,2014-07-23,47%,51%,47,51,-4,2
695,2014-07-22,47%,52%,47,52,-5,1
696,2014-07-21,47%,52%,47,52,-5,1
697,2014-07-20,46%,53%,46,53,-7,1
698,2014-07-19,47%,52%,47,52,-5,1
699,2014-07-18,47%,52%,47,52,-5,1
700,2014-07-17,48%,51%,48,51,-3,1
701,2014-07-16,48%,52%,48,52,-4,0
702,2014-07-15,47%,52%,47,52,-5,1
703,2014-07-14,46%,53%,46,53,-7,1
704,2014-07-13,45%,53%,45,53,-8,2
705,2014-07-12,45%,53%,45,53,-8,2
706,2014-07-11,45%,53%,45,53,-8,2
707,2014-07-10,46%,53%,46,53,-7,1
708,2014-07-09,46%,53%,46,53,-7,1
709,2014-07-08,46%,53%,46,53,-7,1
710,2014-07-07,46%,53%,46,53,-7,1
711,2014-07-03,46%,53%,46,53,-7,1
712,2014-07-02,47%,52%,47,52,-5,1
713,2014-07-01,48%,50%,48,50,-2,2
714,2014-06-30,49%,50%,49,50,-1,1
715,2014-06-29,47%,51%,47,51,-4,2
716,2014-06-28,47%,52%,47,52,-5,1
717,2014-06-27,45%,53%,45,53,-8,2
718,2014-06-26,45%,53%,45,53,-8,2
719,2014-06-26,45%,53%,45,53,-8,2
720,2014-06-25,45%,54%,45,54,-9,1
721,2014-06-24,46%,53%,46,53,-7,1
722,2014-06-23,48%,51%,48,51,-3,1
723,2014-06-22,49%,50%,49,50,-1,1
724,2014-06-21,48%,50%,48,50,-2,2
725,2014-06-20,48%,51%,48,51,-3,1
726,2014-06-19,47%,52%,47,52,-5,1
727,2014-06-18,48%,50%,48,50,-2,2
728,2014-06-17,47%,51%,47,51,-4,2
729,2014-06-16,48%,50%,48,50,-2,2
730,2014-06-15,47%,52%,47,52,-5,1
731,2014-06-14,47%,51%,47,51,-4,2
732,2014-06-13,47%,52%,47,52,-5,1
733,2014-06-12,46%,53%,46,53,-7,1
734,2014-06-11,47%,52%,47,52,-5,1
735,2014-06-10,48%,50%,48,50,-2,2
736,2014-06-09,50%,49%,50,49,1,1
737,2014-06-08,48%,50%,48,50,-2,2
738,2014-06-07,49%,50%,49,50,-1,1
739,2014-06-06,51%,47%,51,47,4,2
740,2014-06-05,52%,46%,52,46,6,2
741,2014-06-04,52%,47%,52,47,5,1
742,2014-06-03,50%,49%,50,49,1,1
743,2014-06-02,49%,50%,49,50,-1,1
744,2014-06-01,48%,50%,48,50,-2,2
745,2014-05-31,48%,50%,48,50,-2,2
746,2014-05-30,48%,50%,48,50,-2,2
747,2014-05-29,49%,50%,49,50,-1,1
748,2014-05-28,49%,49%,49,49,0,2
749,2014-05-27,50%,49%,50,49,1,1
750,2014-05-26,49%,50%,49,50,-1,1
751,2014-05-25,49%,50%,49,50,-1,1
752,2014-05-24,49%,49%,49,49,0,2
753,2014-05-23,50%,48%,50,48,2,2
754,2014-05-22,50%,48%,50,48,2,2
755,2014-05-21,50%,48%,50,48,2,2
756,2014-05-20,49%,50%,49,50,-1,1
757,2014-05-19,48%,50%,48,50,-2,2
758,2014-05-18,46%,52%,46,52,-6,2
759,2014-05-17,45%,53%,45,53,-8,2
760,2014-05-16,47%,51%,47,51,-4,2
761,2014-05-15,49%,49%,49,49,0,2
762,2014-05-14,50%,48%,50,48,2,2
763,2014-05-13,50%,49%,50,49,1,1
764,2014-05-11,50%,49%,50,49,1,1
765,2014-05-10,48%,51%,48,51,-3,1
766,2014-05-09,48%,51%,48,51,-3,1
767,2014-05-08,48%,51%,48,51,-3,1
768,2014-05-07,50%,48%,50,48,2,2
769,2014-05-06,49%,49%,49,49,0,2
770,2014-05-05,47%,52%,47,52,-5,1
771,2014-05-04,46%,52%,46,52,-6,2
772,2014-05-03,46%,52%,46,52,-6,2
773,2014-05-02,47%,51%,47,51,-4,2
774,2014-05-01,47%,51%,47,51,-4,2
775,2014-04-30,48%,51%,48,51,-3,1
776,2014-04-29,48%,51%,48,51,-3,1
777,2014-04-28,47%,52%,47,52,-5,1
778,2014-04-27,47%,52%,47,52,-5,1
779,2014-04-26,46%,54%,46,54,-8,0
780,2014-04-25,45%,54%,45,54,-9,1
781,2014-04-24,45%,54%,45,54,-9,1
782,2014-04-23,47%,51%,47,51,-4,2
783,2014-04-22,48%,50%,48,50,-2,2
784,2014-04-21,49%,50%,49,50,-1,1
785,2014-04-20,46%,53%,46,53,-7,1
786,2014-04-19,45%,54%,45,54,-9,1
787,2014-04-18,45%,54%,45,54,-9,1
788,2014-04-17,46%,53%,46,53,-7,1
789,2014-04-16,48%,52%,48,52,-4,0
790,2014-04-15,47%,52%,47,52,-5,1
791,2014-04-14,47%,52%,47,52,-5,1
792,2014-04-13,47%,52%,47,52,-5,1
793,2014-04-12,49%,50%,49,50,-1,1
794,2014-04-11,50%,49%,50,49,1,1
795,2014-04-10,50%,49%,50,49,1,1
796,2014-04-09,49%,50%,49,50,-1,1
797,2014-04-08,46%,53%,46,53,-7,1
798,2014-04-07,46%,53%,46,53,-7,1
799,2014-04-06,46%,52%,46,52,-6,2
800,2014-04-05,50%,49%,50,49,1,1
801,2014-04-04,50%,49%,50,49,1,1
802,2014-04-03,48%,51%,48,51,-3,1
803,2014-04-02,49%,50%,49,50,-1,1
804,2014-04-01,48%,51%,48,51,-3,1
805,2014-03-31,49%,50%,49,50,-1,1
806,2014-03-30,47%,52%,47,52,-5,1
807,2014-03-29,47%,52%,47,52,-5,1
808,2014-03-28,46%,53%,46,53,-7,1
809,2014-03-27,46%,52%,46,52,-6,2
810,2014-03-26,46%,53%,46,53,-7,1
811,2014-03-25,47%,51%,47,51,-4,2
812,2014-03-24,48%,50%,48,50,-2,2
813,2014-03-23,49%,49%,49,49,0,2
814,2014-03-22,49%,49%,49,49,0,2
815,2014-03-21,48%,51%,48,51,-3,1
816,2014-03-20,49%,50%,49,50,-1,1
817,2014-03-19,49%,49%,49,49,0,2
818,2014-03-18,48%,50%,48,50,-2,2
819,2014-03-17,49%,49%,49,49,0,2
820,2014-03-16,49%,50%,49,50,-1,1
821,2014-03-15,49%,50%,49,50,-1,1
822,2014-03-14,47%,51%,47,51,-4,2
823,2014-03-13,45%,54%,45,54,-9,1
824,2014-03-12,45%,53%,45,53,-8,2
825,2014-03-11,45%,54%,45,54,-9,1
826,2014-03-10,47%,51%,47,51,-4,2
827,2014-03-09,46%,52%,46,52,-6,2
828,2014-03-08,47%,51%,47,51,-4,2
829,2014-03-07,47%,52%,47,52,-5,1
830,2014-03-06,46%,53%,46,53,-7,1
831,2014-03-05,46%,53%,46,53,-7,1
832,2014-03-04,45%,54%,45,54,-9,1
833,2014-03-03,47%,52%,47,52,-5,1
834,2014-03-02,47%,52%,47,52,-5,1
835,2014-03-01,48%,51%,48,51,-3,1
836,2014-02-28,48%,50%,48,50,-2,2
837,2014-02-27,48%,50%,48,50,-2,2
838,2014-02-26,49%,49%,49,49,0,2
839,2014-02-25,50%,49%,50,49,1,1
840,2014-02-24,52%,47%,52,47,5,1
841,2014-02-23,51%,47%,51,47,4,2
842,2014-02-22,51%,47%,51,47,4,2
843,2014-02-21,50%,49%,50,49,1,1
844,2014-02-20,50%,49%,50,49,1,1
845,2014-02-19,48%,51%,48,51,-3,1
846,2014-02-18,48%,51%,48,51,-3,1
847,2014-02-17,48%,50%,48,50,-2,2
848,2014-02-16,51%,48%,51,48,3,1
849,2014-02-15,50%,50%,50,50,0,0
850,2014-02-14,49%,50%,49,50,-1,1
851,2014-02-13,44%,55%,44,55,-11,1
852,2014-02-12,44%,55%,44,55,-11,1
853,2014-02-11,44%,54%,44,54,-10,2
854,2014-02-10,48%,51%,48,51,-3,1
855,2014-02-09,48%,51%,48,51,-3,1
856,2014-02-08,47%,51%,47,51,-4,2
857,2014-02-07,45%,54%,45,54,-9,1
858,2014-02-06,45%,54%,45,54,-9,1
859,2014-02-05,45%,54%,45,54,-9,1
860,2014-02-04,47%,52%,47,52,-5,1
861,2014-02-03,47%,51%,47,51,-4,2
862,2014-02-02,49%,49%,49,49,0,2
863,2014-02-01,48%,50%,48,50,-2,2
864,2014-01-31,48%,51%,48,51,-3,1
865,2014-01-30,46%,53%,46,53,-7,1
866,2014-01-29,47%,52%,47,52,-5,1
867,2014-01-28,48%,51%,48,51,-3,1
868,2014-01-27,50%,49%,50,49,1,1
869,2014-01-26,49%,50%,49,50,-1,1
870,2014-01-25,48%,51%,48,51,-3,1
871,2014-01-24,48%,51%,48,51,-3,1
872,2014-01-23,49%,50%,49,50,-1,1
873,2014-01-22,50%,49%,50,49,1,1
874,2014-01-21,50%,49%,50,49,1,1
875,2014-01-20,49%,50%,49,50,-1,1
876,2014-01-19,47%,51%,47,51,-4,2
877,2014-01-18,49%,49%,49,49,0,2
878,2014-01-17,50%,48%,50,48,2,2
879,2014-01-16,51%,47%,51,47,4,2
880,2014-01-15,50%,49%,50,49,1,1
881,2014-01-14,48%,51%,48,51,-3,1
882,2014-01-13,47%,52%,47,52,-5,1
883,2014-01-12,47%,52%,47,52,-5,1
884,2014-01-11,47%,52%,47,52,-5,1
885,2014-01-10,47%,51%,47,51,-4,2
886,2014-01-09,49%,50%,49,50,-1,1
887,2014-01-08,48%,50%,48,50,-2,2
888,2014-01-07,49%,49%,49,49,0,2
889,2014-01-06,48%,50%,48,50,-2,2
890,2014-01-05,47%,51%,47,51,-4,2
891,2014-01-04,48%,51%,48,51,-3,1
892,2014-01-03,47%,51%,47,51,-4,2
893,2013-12-31,48%,50%,48,50,-2,2
894,2013-12-30,47%,51%,47,51,-4,2
895,2013-12-29,48%,50%,48,50,-2,2
896,2013-12-28,48%,51%,48,51,-3,1
897,2013-12-27,47%,52%,47,52,-5,1
898,2013-12-23,46%,53%,46,53,-7,1
899,2013-12-22,44%,54%,44,54,-10,2
900,2013-12-21,46%,52%,46,52,-6,2
901,2013-12-20,46%,53%,46,53,-7,1
902,2013-12-19,47%,52%,47,52,-5,1
903,2013-12-18,47%,52%,47,52,-5,1
904,2013-12-17,47%,52%,47,52,-5,1
905,2013-12-16,47%,52%,47,52,-5,1
906,2013-12-15,46%,52%,46,52,-6,2
907,2013-12-14,47%,51%,47,51,-4,2
908,2013-12-13,47%,51%,47,51,-4,2
909,2013-12-12,47%,51%,47,51,-4,2
910,2013-12-11,48%,51%,48,51,-3,1
911,2013-12-10,47%,52%,47,52,-5,1
912,2013-12-09,46%,53%,46,53,-7,1
913,2013-12-08,43%,55%,43,55,-12,2
914,2013-12-07,43%,55%,43,55,-12,2
915,2013-12-06,42%,55%,42,55,-13,3
916,2013-12-05,43%,54%,43,54,-11,3
917,2013-12-04,44%,55%,44,55,-11,1
918,2013-12-03,44%,55%,44,55,-11,1
919,2013-12-02,45%,54%,45,54,-9,1
920,2013-11-27,45%,54%,45,54,-9,1
921,2013-11-26,46%,53%,46,53,-7,1
922,2013-11-25,45%,53%,45,53,-8,2
923,2013-11-24,46%,52%,46,52,-6,2
924,2013-11-23,46%,53%,46,53,-7,1
925,2013-11-22,45%,54%,45,54,-9,1
926,2013-11-21,43%,55%,43,55,-12,2
927,2013-11-20,43%,56%,43,56,-13,1
928,2013-11-19,43%,55%,43,55,-12,2
929,2013-11-18,44%,54%,44,54,-10,2
930,2013-11-17,45%,53%,45,53,-8,2
931,2013-11-16,46%,53%,46,53,-7,1
932,2013-11-15,45%,54%,45,54,-9,1
933,2013-11-14,44%,55%,44,55,-11,1
934,2013-11-13,44%,55%,44,55,-11,1
935,2013-11-12,45%,54%,45,54,-9,1
936,2013-11-11,46%,54%,46,54,-8,0
937,2013-11-10,46%,53%,46,53,-7,1
938,2013-11-09,44%,54%,44,54,-10,2
939,2013-11-08,44%,55%,44,55,-11,1
940,2013-11-07,45%,54%,45,54,-9,1
941,2013-11-06,46%,54%,46,54,-8,0
942,2013-11-05,48%,51%,48,51,-3,1
943,2013-11-04,48%,51%,48,51,-3,1
944,2013-11-03,48%,51%,48,51,-3,1
945,2013-11-02,48%,51%,48,51,-3,1
946,2013-11-01,48%,50%,48,50,-2,2
947,2013-10-31,48%,50%,48,50,-2,2
948,2013-10-30,47%,52%,47,52,-5,1
949,2013-10-29,47%,51%,47,51,-4,2
950,2013-10-28,48%,52%,48,52,-4,0
951,2013-10-27,50%,49%,50,49,1,1
952,2013-10-26,51%,48%,51,48,3,1
953,2013-10-25,52%,47%,52,47,5,1
954,2013-10-24,52%,47%,52,47,5,1
955,2013-10-23,52%,47%,52,47,5,1
956,2013-10-22,50%,49%,50,49,1,1
957,2013-10-21,50%,49%,50,49,1,1
958,2013-10-20,50%,49%,50,49,1,1
959,2013-10-19,50%,50%,50,50,0,0
960,2013-10-18,48%,50%,48,50,-2,2
961,2013-10-17,48%,50%,48,50,-2,2
962,2013-10-16,46%,52%,46,52,-6,2
963,2013-10-15,48%,50%,48,50,-2,2
964,2013-10-14,48%,50%,48,50,-2,2
965,2013-10-13,50%,48%,50,48,2,2
966,2013-10-12,51%,48%,51,48,3,1
967,2013-10-11,51%,47%,51,47,4,2
968,2013-10-10,51%,47%,51,47,4,2
969,2013-10-09,50%,49%,50,49,1,1
970,2013-10-08,51%,47%,51,47,4,2
971,2013-10-07,48%,51%,48,51,-3,1
972,2013-10-06,48%,51%,48,51,-3,1
973,2013-10-05,46%,53%,46,53,-7,1
974,2013-10-04,46%,51%,46,51,-5,3
975,2013-10-03,47%,51%,47,51,-4,2
976,2013-10-02,50%,49%,50,49,1,1
977,2013-10-01,52%,47%,52,47,5,1
978,2013-09-30,51%,48%,51,48,3,1
979,2013-09-29,51%,48%,51,48,3,1
980,2013-09-28,48%,50%,48,50,-2,2
981,2013-09-27,49%,50%,49,50,-1,1
982,2013-09-26,48%,51%,48,51,-3,1
983,2013-09-25,49%,50%,49,50,-1,1
984,2013-09-24,49%,50%,49,50,-1,1
985,2013-09-23,46%,51%,46,51,-5,3
986,2013-09-22,47%,51%,47,51,-4,2
987,2013-09-21,46%,51%,46,51,-5,3
988,2013-09-20,49%,50%,49,50,-1,1
989,2013-09-19,48%,50%,48,50,-2,2
990,2013-09-18,49%,50%,49,50,-1,1
991,2013-09-17,48%,51%,48,51,-3,1
992,2013-09-16,47%,52%,47,52,-5,1
993,2013-09-15,46%,52%,46,52,-6,2
994,2013-09-14,47%,51%,47,51,-4,2
995,2013-09-13,46%,51%,46,51,-5,3
996,2013-09-12,46%,52%,46,52,-6,2
997,2013-09-11,45%,54%,45,54,-9,1
998,2013-09-10,45%,54%,45,54,-9,1
999,2013-09-09,45%,54%,45,54,-9,1
1000,2013-09-08,48%,51%,48,51,-3,1
1001,2013-09-07,48%,50%,48,50,-2,2
1002,2013-09-06,49%,49%,49,49,0,2
1003,2013-09-05,48%,50%,48,50,-2,2
1004,2013-09-04,47%,50%,47,50,-3,3
1005,2013-09-03,47%,50%,47,50,-3,3
1006,2013-09-02,49%,49%,49,49,0,2
1007,2013-09-01,50%,48%,50,48,2,2
1008,2013-08-31,49%,49%,49,49,0,2
1009,2013-08-30,48%,50%,48,50,-2,2
1010,2013-08-29,49%,48%,49,48,1,3
1011,2013-08-28,50%,48%,50,48,2,2
1012,2013-08-27,48%,49%,48,49,-1,3
1013,2013-08-26,46%,52%,46,52,-6,2
1014,2013-08-25,45%,54%,45,54,-9,1
1015,2013-08-24,46%,53%,46,53,-7,1
1016,2013-08-23,47%,52%,47,52,-5,1
1017,2013-08-22,48%,51%,48,51,-3,1
1018,2013-08-21,47%,52%,47,52,-5,1
1019,2013-08-20,46%,52%,46,52,-6,2
1020,2013-08-19,47%,52%,47,52,-5,1
1021,2013-08-18,48%,51%,48,51,-3,1
1022,2013-08-17,47%,51%,47,51,-4,2
1023,2013-08-16,46%,51%,46,51,-5,3
1024,2013-08-15,45%,52%,45,52,-7,3
1025,2013-08-14,47%,51%,47,51,-4,2
1026,2013-08-13,47%,52%,47,52,-5,1
1027,2013-08-12,47%,52%,47,52,-5,1
1028,2013-08-11,46%,53%,46,53,-7,1
1029,2013-08-10,47%,52%,47,52,-5,1
1030,2013-08-09,48%,50%,48,50,-2,2
1031,2013-08-08,49%,50%,49,50,-1,1
1032,2013-08-07,48%,51%,48,51,-3,1
1033,2013-08-06,45%,54%,45,54,-9,1
1034,2013-08-05,46%,53%,46,53,-7,1
1035,2013-08-04,46%,52%,46,52,-6,2
1036,2013-08-03,49%,49%,49,49,0,2
1037,2013-08-02,48%,50%,48,50,-2,2
1038,2013-08-01,47%,52%,47,52,-5,1
1039,2013-07-31,46%,53%,46,53,-7,1
1040,2013-07-30,47%,52%,47,52,-5,1
1041,2013-07-29,46%,53%,46,53,-7,1
1042,2013-07-28,46%,52%,46,52,-6,2
1043,2013-07-27,48%,51%,48,51,-3,1
1044,2013-07-26,49%,50%,49,50,-1,1
1045,2013-07-25,50%,50%,50,50,0,0
1046,2013-07-24,48%,51%,48,51,-3,1
1047,2013-07-23,48%,51%,48,51,-3,1
1048,2013-07-22,47%,52%,47,52,-5,1
1049,2013-07-21,48%,51%,48,51,-3,1
1050,2013-07-20,47%,51%,47,51,-4,2
1051,2013-07-19,48%,51%,48,51,-3,1
1052,2013-07-18,48%,51%,48,51,-3,1
1053,2013-07-17,48%,50%,48,50,-2,2
1054,2013-07-16,49%,49%,49,49,0,2
1055,2013-07-15,49%,49%,49,49,0,2
1056,2013-07-14,50%,48%,50,48,2,2
1057,2013-07-13,49%,50%,49,50,-1,1
1058,2013-07-12,48%,51%,48,51,-3,1
1059,2013-07-11,46%,52%,46,52,-6,2
1060,2013-07-10,46%,52%,46,52,-6,2
1061,2013-07-09,47%,52%,47,52,-5,1
1062,2013-07-08,46%,53%,46,53,-7,1
1063,2013-07-07,46%,53%,46,53,-7,1
1064,2013-07-06,46%,53%,46,53,-7,1
1065,2013-07-03,46%,52%,46,52,-6,2
1066,2013-07-02,46%,52%,46,52,-6,2
1067,2013-07-01,47%,52%,47,52,-5,1
1068,2013-06-30,46%,53%,46,53,-7,1
1069,2013-06-29,46%,52%,46,52,-6,2
1070,2013-06-28,45%,53%,45,53,-8,2
1071,2013-06-27,46%,51%,46,51,-5,3
1072,2013-06-26,47%,50%,47,50,-3,3
1073,2013-06-25,49%,49%,49,49,0,2
1074,2013-06-24,49%,49%,49,49,0,2
1075,2013-06-23,48%,51%,48,51,-3,1
1076,2013-06-22,45%,54%,45,54,-9,1
1077,2013-06-21,44%,55%,44,55,-11,1
1078,2013-06-20,46%,53%,46,53,-7,1
1079,2013-06-19,48%,52%,48,52,-4,0
1080,2013-06-18,48%,52%,48,52,-4,0
1081,2013-06-17,47%,52%,47,52,-5,1
1082,2013-06-16,47%,52%,47,52,-5,1
1083,2013-06-15,49%,50%,49,50,-1,1
1084,2013-06-14,48%,51%,48,51,-3,1
1085,2013-06-13,48%,51%,48,51,-3,1
1086,2013-06-12,47%,51%,47,51,-4,2
1087,2013-06-11,47%,51%,47,51,-4,2
1088,2013-06-10,47%,51%,47,51,-4,2
1089,2013-06-09,48%,50%,48,50,-2,2
1090,2013-06-08,49%,49%,49,49,0,2
1091,2013-06-07,51%,48%,51,48,3,1
1092,2013-06-06,52%,47%,52,47,5,1
1093,2013-06-05,50%,48%,50,48,2,2
1094,2013-06-04,49%,50%,49,50,-1,1
1095,2013-06-03,47%,52%,47,52,-5,1
1096,2013-06-02,48%,51%,48,51,-3,1
1097,2013-06-01,50%,49%,50,49,1,1
1098,2013-05-31,52%,47%,52,47,5,1
1099,2013-05-30,51%,49%,51,49,2,0
1100,2013-05-29,49%,51%,49,51,-2,0
1101,2013-05-28,48%,51%,48,51,-3,1
1102,2013-05-27,49%,49%,49,49,0,2
1103,2013-05-26,49%,49%,49,49,0,2
1104,2013-05-25,50%,49%,50,49,1,1
1105,2013-05-24,49%,49%,49,49,0,2
1106,2013-05-23,47%,51%,47,51,-4,2
1107,2013-05-22,46%,53%,46,53,-7,1
1108,2013-05-21,47%,52%,47,52,-5,1
1109,2013-05-20,48%,50%,48,50,-2,2
1110,2013-05-19,49%,49%,49,49,0,2
1111,2013-05-18,48%,50%,48,50,-2,2
1112,2013-05-17,48%,51%,48,51,-3,1
1113,2013-05-16,49%,50%,49,50,-1,1
1114,2013-05-15,49%,49%,49,49,0,2
1115,2013-05-14,50%,48%,50,48,2,2
1116,2013-05-12,51%,48%,51,48,3,1
1117,2013-05-11,51%,48%,51,48,3,1
1118,2013-05-10,50%,48%,50,48,2,2
1119,2013-05-09,48%,50%,48,50,-2,2
1120,2013-05-08,48%,51%,48,51,-3,1
1121,2013-05-07,48%,51%,48,51,-3,1
1122,2013-05-06,50%,48%,50,48,2,2
1123,2013-05-05,50%,48%,50,48,2,2
1124,2013-05-04,48%,50%,48,50,-2,2
1125,2013-05-03,45%,53%,45,53,-8,2
1126,2013-05-02,47%,52%,47,52,-5,1
1127,2013-05-01,49%,49%,49,49,0,2
1128,2013-04-30,51%,46%,51,46,5,3
1129,2013-04-29,50%,47%,50,47,3,3
1130,2013-04-28,50%,48%,50,48,2,2
1131,2013-04-27,49%,49%,49,49,0,2
1132,2013-04-26,50%,49%,50,49,1,1
1133,2013-04-25,48%,50%,48,50,-2,2
1134,2013-04-24,48%,51%,48,51,-3,1
1135,2013-04-23,48%,50%,48,50,-2,2
1136,2013-04-22,51%,48%,51,48,3,1
1137,2013-04-21,52%,47%,52,47,5,1
1138,2013-04-20,51%,48%,51,48,3,1
1139,2013-04-19,50%,49%,50,49,1,1
1140,2013-04-18,49%,49%,49,49,0,2
1141,2013-04-17,51%,47%,51,47,4,2
1142,2013-04-16,52%,47%,52,47,5,1
1143,2013-04-15,53%,46%,53,46,7,1
1144,2013-04-14,51%,47%,51,47,4,2
1145,2013-04-13,51%,48%,51,48,3,1
1146,2013-04-12,50%,49%,50,49,1,1
1147,2013-04-11,49%,49%,49,49,0,2
1148,2013-04-10,48%,50%,48,50,-2,2
1149,2013-04-09,49%,49%,49,49,0,2
1150,2013-04-08,50%,49%,50,49,1,1
1151,2013-04-07,51%,48%,51,48,3,1
1152,2013-04-06,51%,49%,51,49,2,0
1153,2013-04-05,51%,49%,51,49,2,0
1154,2013-04-04,50%,49%,50,49,1,1
1155,2013-04-03,50%,49%,50,49,1,1
1156,2013-04-02,49%,49%,49,49,0,2
1157,2013-04-01,52%,46%,52,46,6,2
1158,2013-03-31,52%,46%,52,46,6,2
1159,2013-03-30,54%,45%,54,45,9,1
1160,2013-03-29,53%,45%,53,45,8,2
1161,2013-03-28,53%,46%,53,46,7,1
1162,2013-03-27,51%,48%,51,48,3,1
1163,2013-03-26,51%,48%,51,48,3,1
1164,2013-03-25,52%,47%,52,47,5,1
1165,2013-03-24,53%,47%,53,47,6,0
1166,2013-03-23,52%,47%,52,47,5,1
1167,2013-03-22,52%,47%,52,47,5,1
1168,2013-03-21,52%,47%,52,47,5,1
1169,2013-03-20,52%,47%,52,47,5,1
1170,2013-03-19,50%,48%,50,48,2,2
1171,2013-03-18,51%,47%,51,47,4,2
1172,2013-03-17,51%,47%,51,47,4,2
1173,2013-03-16,51%,48%,51,48,3,1
1174,2013-03-15,50%,49%,50,49,1,1
1175,2013-03-14,50%,49%,50,49,1,1
1176,2013-03-13,51%,49%,51,49,2,0
1177,2013-03-12,52%,47%,52,47,5,1
1178,2013-03-11,51%,48%,51,48,3,1
1179,2013-03-10,51%,48%,51,48,3,1
1180,2013-03-09,51%,48%,51,48,3,1
1181,2013-03-08,51%,48%,51,48,3,1
1182,2013-03-07,51%,48%,51,48,3,1
1183,2013-03-06,51%,48%,51,48,3,1
1184,2013-03-05,51%,48%,51,48,3,1
1185,2013-03-04,51%,47%,51,47,4,2
1186,2013-03-03,51%,47%,51,47,4,2
1187,2013-03-02,52%,47%,52,47,5,1
1188,2013-03-01,52%,46%,52,46,6,2
1189,2013-02-28,51%,48%,51,48,3,1
1190,2013-02-27,50%,48%,50,48,2,2
1191,2013-02-26,52%,47%,52,47,5,1
1192,2013-02-25,54%,45%,54,45,9,1
1193,2013-02-24,54%,46%,54,46,8,0
1194,2013-02-23,52%,47%,52,47,5,1
1195,2013-02-22,52%,47%,52,47,5,1
1196,2013-02-21,51%,47%,51,47,4,2
1197,2013-02-20,52%,46%,52,46,6,2
1198,2013-02-19,53%,46%,53,46,7,1
1199,2013-02-18,54%,46%,54,46,8,0
1200,2013-02-17,52%,47%,52,47,5,1
1201,2013-02-16,53%,46%,53,46,7,1
1202,2013-02-15,53%,46%,53,46,7,1
1203,2013-02-14,54%,45%,54,45,9,1
1204,2013-02-13,56%,44%,56,44,12,0
1205,2013-02-12,55%,44%,55,44,11,1
1206,2013-02-11,54%,45%,54,45,9,1
1207,2013-02-10,52%,47%,52,47,5,1
1208,2013-02-09,52%,46%,52,46,6,2
1209,2013-02-08,52%,47%,52,47,5,1
1210,2013-02-07,51%,48%,51,48,3,1
1211,2013-02-06,53%,46%,53,46,7,1
1212,2013-02-05,54%,45%,54,45,9,1
1213,2013-02-04,55%,44%,55,44,11,1
1214,2013-02-03,54%,45%,54,45,9,1
1215,2013-02-02,54%,45%,54,45,9,1
1216,2013-02-01,56%,44%,56,44,12,0
1217,2013-01-31,54%,45%,54,45,9,1
1218,2013-01-30,53%,46%,53,46,7,1
1219,2013-01-29,53%,46%,53,46,7,1
1220,2013-01-28,54%,46%,54,46,8,0
1221,2013-01-27,55%,45%,55,45,10,0
1222,2013-01-26,54%,45%,54,45,9,1
1223,2013-01-25,55%,44%,55,44,11,1
1224,2013-01-24,54%,45%,54,45,9,1
1225,2013-01-23,55%,43%,55,43,12,2
1226,2013-01-22,55%,44%,55,44,11,1
1227,2013-01-21,55%,45%,55,45,10,0
1228,2013-01-20,55%,45%,55,45,10,0
1229,2013-01-19,54%,45%,54,45,9,1
1230,2013-01-18,54%,45%,54,45,9,1
1231,2013-01-17,55%,45%,55,45,10,0
1232,2013-01-16,54%,46%,54,46,8,0
1233,2013-01-15,54%,45%,54,45,9,1
1234,2013-01-14,54%,44%,54,44,10,2
1235,2013-01-13,55%,43%,55,43,12,2
1236,2013-01-12,54%,44%,54,44,10,2
1237,2013-01-11,52%,46%,52,46,6,2
1238,2013-01-10,52%,45%,52,45,7,3
1239,2013-01-09,53%,45%,53,45,8,2
1240,2013-01-08,54%,43%,54,43,11,3
1241,2013-01-07,53%,45%,53,45,8,2
1242,2013-01-06,55%,43%,55,43,12,2
1243,2013-01-05,56%,43%,56,43,13,1
1244,2013-01-04,57%,41%,57,41,16,2
1245,2013-01-03,57%,42%,57,42,15,1
1246,2012-12-31,57%,41%,57,41,16,2
1247,2012-12-30,57%,42%,57,42,15,1
1248,2012-12-29,56%,43%,56,43,13,1
1249,2012-12-28,55%,43%,55,43,12,2
1250,2012-12-27,55%,43%,55,43,12,2
1251,2012-12-23,56%,43%,56,43,13,1
1252,2012-12-22,57%,42%,57,42,15,1
1253,2012-12-21,56%,43%,56,43,13,1
1254,2012-12-20,56%,43%,56,43,13,1
1255,2012-12-19,55%,43%,55,43,12,2
1256,2012-12-18,55%,43%,55,43,12,2
1257,2012-12-17,55%,44%,55,44,11,1
1258,2012-12-16,57%,42%,57,42,15,1
1259,2012-12-15,56%,42%,56,42,14,2
1260,2012-12-14,55%,43%,55,43,12,2
1261,2012-12-13,52%,46%,52,46,6,2
1262,2012-12-12,55%,44%,55,44,11,1
1263,2012-12-11,56%,43%,56,43,13,1
1264,2012-12-10,58%,41%,58,41,17,1
1265,2012-12-09,56%,43%,56,43,13,1
1266,2012-12-08,56%,43%,56,43,13,1
1267,2012-12-07,53%,46%,53,46,7,1
1268,2012-12-06,54%,45%,54,45,9,1
1269,2012-12-05,55%,44%,55,44,11,1
1270,2012-12-04,56%,43%,56,43,13,1
1271,2012-12-03,56%,42%,56,42,14,2
1272,2012-12-02,56%,44%,56,44,12,0
1273,2012-12-01,55%,44%,55,44,11,1
1274,2012-11-30,54%,45%,54,45,9,1
1275,2012-11-29,55%,44%,55,44,11,1
1276,2012-11-28,54%,45%,54,45,9,1
1277,2012-11-27,55%,44%,55,44,11,1
1278,2012-11-26,54%,45%,54,45,9,1
1279,2012-11-21,54%,45%,54,45,9,1
1280,2012-11-20,55%,44%,55,44,11,1
1281,2012-11-19,53%,46%,53,46,7,1
1282,2012-11-18,53%,46%,53,46,7,1
1283,2012-11-17,53%,46%,53,46,7,1
1284,2012-11-16,53%,46%,53,46,7,1
1285,2012-11-15,54%,45%,54,45,9,1
1286,2012-11-14,54%,45%,54,45,9,1
1287,2012-11-13,55%,44%,55,44,11,1
1288,2012-11-12,54%,45%,54,45,9,1
1289,2012-11-11,53%,45%,53,45,8,2
1290,2012-11-10,51%,47%,51,47,4,2
1291,2012-11-09,51%,48%,51,48,3,1
1292,2012-11-08,52%,47%,52,47,5,1
1293,2012-11-07,52%,48%,52,48,4,0
1294,2012-11-06,50%,49%,50,49,1,1
1295,2012-11-05,50%,49%,50,49,1,1
1296,2012-11-04,51%,49%,51,49,2,0
1297,2012-11-03,51%,48%,51,48,3,1
1298,2012-11-02,50%,49%,50,49,1,1
1299,2012-11-01,49%,49%,49,49,0,2
1300,2012-10-31,49%,49%,49,49,0,2
1301,2012-10-30,49%,50%,49,50,-1,1
1302,2012-10-29,49%,51%,49,51,-2,0
1303,2012-10-28,47%,52%,47,52,-5,1
1304,2012-10-27,47%,52%,47,52,-5,1
1305,2012-10-26,48%,51%,48,51,-3,1
1306,2012-10-25,49%,50%,49,50,-1,1
1307,2012-10-24,49%,49%,49,49,0,2
1308,2012-10-23,50%,49%,50,49,1,1
1309,2012-10-22,50%,49%,50,49,1,1
1310,2012-10-21,49%,51%,49,51,-2,0
1311,2012-10-20,47%,52%,47,52,-5,1
1312,2012-10-19,48%,51%,48,51,-3,1
1313,2012-10-18,48%,51%,48,51,-3,1
1314,2012-10-17,49%,50%,49,50,-1,1
1315,2012-10-16,48%,51%,48,51,-3,1
1316,2012-10-15,49%,50%,49,50,-1,1
1317,2012-10-14,48%,51%,48,51,-3,1
1318,2012-10-13,50%,49%,50,49,1,1
1319,2012-10-12,50%,49%,50,49,1,1
1320,2012-10-11,51%,48%,51,48,3,1
1321,2012-10-10,49%,50%,49,50,-1,1
1322,2012-10-09,49%,50%,49,50,-1,1
1323,2012-10-08,51%,49%,51,49,2,0
1324,2012-10-07,50%,49%,50,49,1,1
1325,2012-10-06,50%,49%,50,49,1,1
1326,2012-10-05,50%,48%,50,48,2,2
1327,2012-10-04,49%,49%,49,49,0,2
1328,2012-10-03,49%,50%,49,50,-1,1
1329,2012-10-02,48%,51%,48,51,-3,1
1330,2012-10-01,49%,49%,49,49,0,2
1331,2012-09-30,50%,49%,50,49,1,1
1332,2012-09-29,49%,50%,49,50,-1,1
1333,2012-09-28,48%,51%,48,51,-3,1
1334,2012-09-27,48%,51%,48,51,-3,1
1335,2012-09-26,48%,51%,48,51,-3,1
1336,2012-09-25,48%,51%,48,51,-3,1
1337,2012-09-24,48%,50%,48,50,-2,2
1338,2012-09-23,48%,50%,48,50,-2,2
1339,2012-09-22,50%,49%,50,49,1,1
1340,2012-09-21,51%,48%,51,48,3,1
1341,2012-09-20,51%,48%,51,48,3,1
1342,2012-09-19,49%,50%,49,50,-1,1
1343,2012-09-18,49%,50%,49,50,-1,1
1344,2012-09-17,49%,50%,49,50,-1,1
1345,2012-09-16,50%,49%,50,49,1,1
1346,2012-09-15,49%,50%,49,50,-1,1
1347,2012-09-14,48%,52%,48,52,-4,0
1348,2012-09-13,49%,51%,49,51,-2,0
1349,2012-09-12,51%,48%,51,48,3,1
1350,2012-09-11,52%,47%,52,47,5,1
1351,2012-09-10,52%,47%,52,47,5,1
1352,2012-09-09,52%,47%,52,47,5,1
1353,2012-09-08,49%,50%,49,50,-1,1
1354,2012-09-07,47%,52%,47,52,-5,1
1355,2012-09-06,46%,54%,46,54,-8,0
1356,2012-09-05,47%,52%,47,52,-5,1
1357,2012-09-04,48%,51%,48,51,-3,1
1358,2012-09-03,48%,52%,48,52,-4,0
1359,2012-09-02,48%,51%,48,51,-3,1
1360,2012-09-01,48%,52%,48,52,-4,0
1361,2012-08-31,49%,51%,49,51,-2,0
1362,2012-08-30,49%,51%,49,51,-2,0
1363,2012-08-29,50%,50%,50,50,0,0
1364,2012-08-28,50%,49%,50,49,1,1
1365,2012-08-27,50%,49%,50,49,1,1
1366,2012-08-26,49%,50%,49,50,-1,1
1367,2012-08-25,48%,50%,48,50,-2,2
1368,2012-08-24,48%,51%,48,51,-3,1
1369,2012-08-23,48%,51%,48,51,-3,1
1370,2012-08-22,48%,51%,48,51,-3,1
1371,2012-08-21,49%,50%,49,50,-1,1
1372,2012-08-20,49%,49%,49,49,0,2
1373,2012-08-19,48%,51%,48,51,-3,1
1374,2012-08-18,47%,51%,47,51,-4,2
1375,2012-08-17,48%,51%,48,51,-3,1
1376,2012-08-16,48%,51%,48,51,-3,1
1377,2012-08-15,47%,52%,47,52,-5,1
1378,2012-08-14,48%,52%,48,52,-4,0
1379,2012-08-13,45%,53%,45,53,-8,2
1380,2012-08-12,45%,53%,45,53,-8,2
1381,2012-08-11,43%,54%,43,54,-11,3
1382,2012-08-10,45%,53%,45,53,-8,2
1383,2012-08-09,46%,53%,46,53,-7,1
1384,2012-08-08,49%,50%,49,50,-1,1
1385,2012-08-07,49%,50%,49,50,-1,1
1386,2012-08-06,48%,50%,48,50,-2,2
1387,2012-08-05,46%,52%,46,52,-6,2
1388,2012-08-04,45%,53%,45,53,-8,2
1389,2012-08-03,44%,54%,44,54,-10,2
1390,2012-08-02,45%,53%,45,53,-8,2
1391,2012-08-01,47%,52%,47,52,-5,1
1392,2012-07-31,47%,52%,47,52,-5,1
1393,2012-07-30,47%,52%,47,52,-5,1
1394,2012-07-29,46%,53%,46,53,-7,1
1395,2012-07-28,47%,53%,47,53,-6,0
1396,2012-07-27,47%,53%,47,53,-6,0
1397,2012-07-26,48%,51%,48,51,-3,1
1398,2012-07-25,48%,51%,48,51,-3,1
1399,2012-07-24,48%,50%,48,50,-2,2
1400,2012-07-23,49%,50%,49,50,-1,1
1401,2012-07-22,49%,50%,49,50,-1,1
1402,2012-07-21,48%,51%,48,51,-3,1
1403,2012-07-20,47%,51%,47,51,-4,2
1404,2012-07-19,47%,51%,47,51,-4,2
1405,2012-07-18,46%,51%,46,51,-5,3
1406,2012-07-17,46%,52%,46,52,-6,2
1407,2012-07-16,47%,52%,47,52,-5,1
1408,2012-07-15,48%,51%,48,51,-3,1
1409,2012-07-14,49%,50%,49,50,-1,1
1410,2012-07-13,48%,51%,48,51,-3,1
1411,2012-07-12,46%,52%,46,52,-6,2
1412,2012-07-11,47%,52%,47,52,-5,1
1413,2012-07-10,45%,53%,45,53,-8,2
1414,2012-07-09,47%,52%,47,52,-5,1
1415,2012-07-08,49%,50%,49,50,-1,1
1416,2012-07-07,50%,49%,50,49,1,1
1417,2012-07-06,49%,50%,49,50,-1,1
1418,2012-07-03,46%,53%,46,53,-7,1
1419,2012-07-02,46%,53%,46,53,-7,1
1420,2012-07-01,48%,51%,48,51,-3,1
1421,2012-06-30,50%,49%,50,49,1,1
1422,2012-06-29,49%,49%,49,49,0,2
1423,2012-06-28,47%,51%,47,51,-4,2
1424,2012-06-27,47%,52%,47,52,-5,1
1425,2012-06-26,46%,52%,46,52,-6,2
1426,2012-06-25,46%,52%,46,52,-6,2
1427,2012-06-24,44%,54%,44,54,-10,2
1428,2012-06-23,44%,54%,44,54,-10,2
1429,2012-06-22,44%,54%,44,54,-10,2
1430,2012-06-21,47%,52%,47,52,-5,1
1431,2012-06-20,47%,52%,47,52,-5,1
1432,2012-06-19,45%,53%,45,53,-8,2
1433,2012-06-18,46%,53%,46,53,-7,1
1434,2012-06-17,46%,53%,46,53,-7,1
1435,2012-06-16,48%,51%,48,51,-3,1
1436,2012-06-15,48%,51%,48,51,-3,1
1437,2012-06-14,48%,51%,48,51,-3,1
1438,2012-06-13,47%,52%,47,52,-5,1
1439,2012-06-12,48%,52%,48,52,-4,0
1440,2012-06-11,47%,52%,47,52,-5,1
1441,2012-06-10,48%,51%,48,51,-3,1
1442,2012-06-09,47%,52%,47,52,-5,1
1443,2012-06-08,48%,51%,48,51,-3,1
1444,2012-06-07,48%,51%,48,51,-3,1
1445,2012-06-06,49%,50%,49,50,-1,1
1446,2012-06-05,47%,52%,47,52,-5,1
1447,2012-06-04,47%,52%,47,52,-5,1
1448,2012-06-03,45%,53%,45,53,-8,2
1449,2012-06-02,46%,53%,46,53,-7,1
1450,2012-06-01,48%,51%,48,51,-3,1
1451,2012-05-31,49%,50%,49,50,-1,1
1452,2012-05-30,49%,49%,49,49,0,2
1453,2012-05-29,49%,50%,49,50,-1,1
1454,2012-05-28,49%,50%,49,50,-1,1
1455,2012-05-27,49%,50%,49,50,-1,1
1456,2012-05-26,49%,49%,49,49,0,2
1457,2012-05-25,49%,50%,49,50,-1,1
1458,2012-05-24,51%,49%,51,49,2,0
1459,2012-05-23,51%,48%,51,48,3,1
1460,2012-05-22,50%,50%,50,50,0,0
1461,2012-05-21,50%,49%,50,49,1,1
1462,2012-05-20,49%,50%,49,50,-1,1
1463,2012-05-19,49%,50%,49,50,-1,1
1464,2012-05-18,48%,52%,48,52,-4,0
1465,2012-05-17,47%,52%,47,52,-5,1
1466,2012-05-16,47%,52%,47,52,-5,1
1467,2012-05-15,47%,52%,47,52,-5,1
1468,2012-05-13,46%,53%,46,53,-7,1
1469,2012-05-12,44%,55%,44,55,-11,1
1470,2012-05-11,44%,55%,44,55,-11,1
1471,2012-05-10,46%,53%,46,53,-7,1
1472,2012-05-09,46%,53%,46,53,-7,1
1473,2012-05-08,47%,52%,47,52,-5,1
1474,2012-05-07,48%,52%,48,52,-4,0
1475,2012-05-06,49%,50%,49,50,-1,1
1476,2012-05-05,50%,49%,50,49,1,1
1477,2012-05-04,49%,49%,49,49,0,2
1478,2012-05-03,50%,49%,50,49,1,1
1479,2012-05-02,49%,50%,49,50,-1,1
1480,2012-05-01,47%,52%,47,52,-5,1
1481,2012-04-30,47%,52%,47,52,-5,1
1482,2012-04-29,47%,52%,47,52,-5,1
1483,2012-04-28,49%,50%,49,50,-1,1
1484,2012-04-27,48%,51%,48,51,-3,1
1485,2012-04-26,48%,51%,48,51,-3,1
1486,2012-04-25,46%,53%,46,53,-7,1
1487,2012-04-24,46%,53%,46,53,-7,1
1488,2012-04-23,45%,54%,45,54,-9,1
1489,2012-04-22,47%,52%,47,52,-5,1
1490,2012-04-21,50%,50%,50,50,0,0
1491,2012-04-20,49%,50%,49,50,-1,1
1492,2012-04-19,49%,50%,49,50,-1,1
1493,2012-04-18,47%,51%,47,51,-4,2
1494,2012-04-17,48%,50%,48,50,-2,2
1495,2012-04-16,47%,51%,47,51,-4,2
1496,2012-04-15,46%,52%,46,52,-6,2
1497,2012-04-14,45%,52%,45,52,-7,3
1498,2012-04-13,46%,51%,46,51,-5,3
1499,2012-04-12,48%,50%,48,50,-2,2
1500,2012-04-11,48%,51%,48,51,-3,1
1501,2012-04-10,47%,52%,47,52,-5,1
1502,2012-04-09,49%,50%,49,50,-1,1
1503,2012-04-08,49%,50%,49,50,-1,1
1504,2012-04-07,49%,50%,49,50,-1,1
1505,2012-04-06,47%,52%,47,52,-5,1
1506,2012-04-05,46%,53%,46,53,-7,1
1507,2012-04-04,45%,54%,45,54,-9,1
1508,2012-04-03,46%,52%,46,52,-6,2
1509,2012-04-02,47%,52%,47,52,-5,1
1510,2012-04-01,47%,52%,47,52,-5,1
1511,2012-03-31,47%,52%,47,52,-5,1
1512,2012-03-30,48%,52%,48,52,-4,0
1513,2012-03-29,46%,53%,46,53,-7,1
1514,2012-03-28,48%,51%,48,51,-3,1
1515,2012-03-27,47%,52%,47,52,-5,1
1516,2012-03-26,49%,51%,49,51,-2,0
1517,2012-03-25,46%,52%,46,52,-6,2
1518,2012-03-24,47%,52%,47,52,-5,1
1519,2012-03-23,47%,51%,47,51,-4,2
1520,2012-03-22,47%,51%,47,51,-4,2
1521,2012-03-21,48%,50%,48,50,-2,2
1522,2012-03-20,49%,50%,49,50,-1,1
1523,2012-03-19,49%,50%,49,50,-1,1
1524,2012-03-18,49%,50%,49,50,-1,1
1525,2012-03-17,50%,49%,50,49,1,1
1526,2012-03-16,49%,49%,49,49,0,2
1527,2012-03-15,47%,51%,47,51,-4,2
1528,2012-03-14,47%,52%,47,52,-5,1
1529,2012-03-13,49%,51%,49,51,-2,0
1530,2012-03-12,47%,52%,47,52,-5,1
1531,2012-03-11,44%,54%,44,54,-10,2
1532,2012-03-10,44%,54%,44,54,-10,2
1533,2012-03-09,46%,53%,46,53,-7,1
1534,2012-03-08,49%,50%,49,50,-1,1
1535,2012-03-07,49%,50%,49,50,-1,1
1536,2012-03-06,48%,51%,48,51,-3,1
1537,2012-03-05,45%,54%,45,54,-9,1
1538,2012-03-04,46%,53%,46,53,-7,1
1539,2012-03-03,46%,53%,46,53,-7,1
1540,2012-03-02,48%,52%,48,52,-4,0
1541,2012-03-01,48%,51%,48,51,-3,1
1542,2012-02-29,48%,51%,48,51,-3,1
1543,2012-02-28,47%,52%,47,52,-5,1
1544,2012-02-27,45%,53%,45,53,-8,2
1545,2012-02-26,46%,53%,46,53,-7,1
1546,2012-02-25,47%,51%,47,51,-4,2
1547,2012-02-24,49%,50%,49,50,-1,1
1548,2012-02-23,50%,49%,50,49,1,1
1549,2012-02-22,50%,49%,50,49,1,1
1550,2012-02-21,49%,49%,49,49,0,2
1551,2012-02-20,49%,48%,49,48,1,3
1552,2012-02-19,49%,50%,49,50,-1,1
1553,2012-02-18,50%,49%,50,49,1,1
1554,2012-02-17,48%,51%,48,51,-3,1
1555,2012-02-16,49%,50%,49,50,-1,1
1556,2012-02-15,49%,49%,49,49,0,2
1557,2012-02-14,51%,47%,51,47,4,2
1558,2012-02-13,50%,48%,50,48,2,2
1559,2012-02-12,49%,49%,49,49,0,2
1560,2012-02-11,49%,50%,49,50,-1,1
1561,2012-02-10,51%,49%,51,49,2,0
1562,2012-02-09,50%,49%,50,49,1,1
1563,2012-02-08,50%,49%,50,49,1,1
1564,2012-02-07,51%,48%,51,48,3,1
1565,2012-02-06,50%,48%,50,48,2,2
1566,2012-02-05,48%,50%,48,50,-2,2
1567,2012-02-04,47%,51%,47,51,-4,2
1568,2012-02-03,46%,52%,46,52,-6,2
1569,2012-02-02,47%,51%,47,51,-4,2
1570,2012-02-01,49%,49%,49,49,0,2
1571,2012-01-31,51%,48%,51,48,3,1
1572,2012-01-30,51%,47%,51,47,4,2
1573,2012-01-29,49%,50%,49,50,-1,1
1574,2012-01-28,47%,51%,47,51,-4,2
1575,2012-01-27,46%,52%,46,52,-6,2
1576,2012-01-26,46%,52%,46,52,-6,2
1577,2012-01-25,48%,51%,48,51,-3,1
1578,2012-01-24,48%,51%,48,51,-3,1
1579,2012-01-23,47%,52%,47,52,-5,1
1580,2012-01-22,45%,53%,45,53,-8,2
1581,2012-01-21,46%,52%,46,52,-6,2
1582,2012-01-20,47%,52%,47,52,-5,1
1583,2012-01-19,47%,52%,47,52,-5,1
1584,2012-01-18,46%,52%,46,52,-6,2
1585,2012-01-17,46%,53%,46,53,-7,1
1586,2012-01-16,45%,54%,45,54,-9,1
1587,2012-01-15,45%,53%,45,53,-8,2
1588,2012-01-14,46%,53%,46,53,-7,1
1589,2012-01-13,47%,52%,47,52,-5,1
1590,2012-01-12,47%,52%,47,52,-5,1
1591,2012-01-11,46%,54%,46,54,-8,0
1592,2012-01-10,44%,55%,44,55,-11,1
1593,2012-01-09,44%,55%,44,55,-11,1
1594,2012-01-08,46%,53%,46,53,-7,1
1595,2012-01-07,46%,53%,46,53,-7,1
1596,2012-01-06,46%,53%,46,53,-7,1
1597,2012-01-05,45%,53%,45,53,-8,2
1598,2012-01-04,46%,53%,46,53,-7,1
1599,2012-01-03,46%,53%,46,53,-7,1
1600,2011-12-31,46%,52%,46,52,-6,2
1601,2011-12-30,44%,54%,44,54,-10,2
1602,2011-12-29,45%,55%,45,55,-10,0
1603,2011-12-28,45%,54%,45,54,-9,1
1604,2011-12-27,47%,52%,47,52,-5,1
1605,2011-12-23,47%,51%,47,51,-4,2
1606,2011-12-22,49%,50%,49,50,-1,1
1607,2011-12-21,47%,51%,47,51,-4,2
1608,2011-12-20,47%,51%,47,51,-4,2
1609,2011-12-19,47%,51%,47,51,-4,2
1610,2011-12-18,47%,52%,47,52,-5,1
1611,2011-12-17,47%,53%,47,53,-6,0
1612,2011-12-16,47%,52%,47,52,-5,1
1613,2011-12-15,47%,52%,47,52,-5,1
1614,2011-12-14,46%,52%,46,52,-6,2
1615,2011-12-13,46%,53%,46,53,-7,1
1616,2011-12-12,46%,52%,46,52,-6,2
1617,2011-12-11,45%,53%,45,53,-8,2
1618,2011-12-10,44%,55%,44,55,-11,1
1619,2011-12-09,44%,55%,44,55,-11,1
1620,2011-12-08,45%,55%,45,55,-10,0
1621,2011-12-07,45%,54%,45,54,-9,1
1622,2011-12-06,45%,54%,45,54,-9,1
1623,2011-12-05,46%,53%,46,53,-7,1
1624,2011-12-04,46%,52%,46,52,-6,2
1625,2011-12-03,45%,54%,45,54,-9,1
1626,2011-12-02,43%,55%,43,55,-12,2
1627,2011-12-01,43%,56%,43,56,-13,1
1628,2011-11-30,43%,56%,43,56,-13,1
1629,2011-11-29,44%,55%,44,55,-11,1
1630,2011-11-28,44%,54%,44,54,-10,2
1631,2011-11-23,44%,53%,44,53,-9,3
1632,2011-11-22,45%,52%,45,52,-7,3
1633,2011-11-21,46%,52%,46,52,-6,2
1634,2011-11-20,47%,51%,47,51,-4,2
1635,2011-11-19,46%,52%,46,52,-6,2
1636,2011-11-18,44%,54%,44,54,-10,2
1637,2011-11-17,44%,56%,44,56,-12,0
1638,2011-11-16,47%,53%,47,53,-6,0
1639,2011-11-15,49%,51%,49,51,-2,0
1640,2011-11-14,50%,49%,50,49,1,1
1641,2011-11-13,48%,51%,48,51,-3,1
1642,2011-11-12,47%,52%,47,52,-5,1
1643,2011-11-11,46%,53%,46,53,-7,1
1644,2011-11-10,45%,53%,45,53,-8,2
1645,2011-11-09,45%,54%,45,54,-9,1
1646,2011-11-08,45%,54%,45,54,-9,1
1647,2011-11-07,47%,52%,47,52,-5,1
1648,2011-11-06,45%,53%,45,53,-8,2
1649,2011-11-05,46%,53%,46,53,-7,1
1650,2011-11-04,44%,54%,44,54,-10,2
1651,2011-11-03,46%,52%,46,52,-6,2
1652,2011-11-02,44%,55%,44,55,-11,1
1653,2011-11-01,44%,55%,44,55,-11,1
1654,2011-10-31,45%,54%,45,54,-9,1
1655,2011-10-30,46%,53%,46,53,-7,1
1656,2011-10-29,46%,52%,46,52,-6,2
1657,2011-10-28,44%,54%,44,54,-10,2
1658,2011-10-27,43%,55%,43,55,-12,2
1659,2011-10-26,43%,55%,43,55,-12,2
1660,2011-10-25,44%,54%,44,54,-10,2
1661,2011-10-24,45%,54%,45,54,-9,1
1662,2011-10-23,43%,56%,43,56,-13,1
1663,2011-10-22,42%,56%,42,56,-14,2
1664,2011-10-21,44%,55%,44,55,-11,1
1665,2011-10-20,45%,54%,45,54,-9,1
1666,2011-10-19,45%,54%,45,54,-9,1
1667,2011-10-18,44%,55%,44,55,-11,1
1668,2011-10-17,43%,55%,43,55,-12,2
1669,2011-10-16,45%,54%,45,54,-9,1
1670,2011-10-15,46%,53%,46,53,-7,1
1671,2011-10-14,47%,53%,47,53,-6,0
1672,2011-10-13,47%,52%,47,52,-5,1
1673,2011-10-12,45%,53%,45,53,-8,2
1674,2011-10-11,44%,54%,44,54,-10,2
1675,2011-10-10,42%,55%,42,55,-13,3
1676,2011-10-09,42%,56%,42,56,-14,2
1677,2011-10-08,43%,55%,43,55,-12,2
1678,2011-10-07,42%,57%,42,57,-15,1
1679,2011-10-06,42%,56%,42,56,-14,2
1680,2011-10-05,42%,56%,42,56,-14,2
1681,2011-10-04,44%,54%,44,54,-10,2
1682,2011-10-03,44%,54%,44,54,-10,2
1683,2011-10-02,45%,54%,45,54,-9,1
1684,2011-10-01,46%,53%,46,53,-7,1
1685,2011-09-30,46%,53%,46,53,-7,1
1686,2011-09-29,45%,53%,45,53,-8,2
1687,2011-09-28,46%,53%,46,53,-7,1
1688,2011-09-27,45%,53%,45,53,-8,2
1689,2011-09-26,44%,54%,44,54,-10,2
1690,2011-09-25,44%,54%,44,54,-10,2
1691,2011-09-24,44%,54%,44,54,-10,2
1692,2011-09-23,46%,52%,46,52,-6,2
1693,2011-09-22,46%,52%,46,52,-6,2
1694,2011-09-21,46%,52%,46,52,-6,2
1695,2011-09-20,46%,52%,46,52,-6,2
1696,2011-09-19,45%,54%,45,54,-9,1
1697,2011-09-18,45%,55%,45,55,-10,0
1698,2011-09-17,45%,55%,45,55,-10,0
1699,2011-09-16,46%,53%,46,53,-7,1
1700,2011-09-15,46%,53%,46,53,-7,1
1701,2011-09-14,45%,54%,45,54,-9,1
1702,2011-09-13,45%,54%,45,54,-9,1
1703,2011-09-12,44%,55%,44,55,-11,1
1704,2011-09-11,42%,55%,42,55,-13,3
1705,2011-09-10,42%,55%,42,55,-13,3
1706,2011-09-09,42%,56%,42,56,-14,2
1707,2011-09-08,43%,56%,43,56,-13,1
1708,2011-09-07,42%,56%,42,56,-14,2
1709,2011-09-06,43%,55%,43,55,-12,2
1710,2011-09-05,44%,55%,44,55,-11,1
1711,2011-09-04,44%,55%,44,55,-11,1
1712,2011-09-03,45%,54%,45,54,-9,1
1713,2011-09-02,44%,55%,44,55,-11,1
1714,2011-09-01,43%,56%,43,56,-13,1
1715,2011-08-31,42%,57%,42,57,-15,1
1716,2011-08-30,43%,56%,43,56,-13,1
1717,2011-08-29,45%,55%,45,55,-10,0
1718,2011-08-28,46%,54%,46,54,-8,0
1719,2011-08-27,45%,54%,45,54,-9,1
1720,2011-08-26,43%,56%,43,56,-13,1
1721,2011-08-25,42%,57%,42,57,-15,1
1722,2011-08-24,44%,56%,44,56,-12,0
1723,2011-08-23,44%,56%,44,56,-12,0
1724,2011-08-22,44%,55%,44,55,-11,1
1725,2011-08-21,44%,55%,44,55,-11,1
1726,2011-08-20,45%,53%,45,53,-8,2
1727,2011-08-19,45%,53%,45,53,-8,2
1728,2011-08-18,43%,54%,43,54,-11,3
1729,2011-08-17,43%,55%,43,55,-12,2
1730,2011-08-16,43%,54%,43,54,-11,3
1731,2011-08-15,44%,54%,44,54,-10,2
1732,2011-08-14,44%,54%,44,54,-10,2
1733,2011-08-13,44%,54%,44,54,-10,2
1734,2011-08-12,43%,55%,43,55,-12,2
1735,2011-08-11,43%,56%,43,56,-13,1
1736,2011-08-10,43%,56%,43,56,-13,1
1737,2011-08-09,45%,55%,45,55,-10,0
1738,2011-08-08,46%,52%,46,52,-6,2
1739,2011-08-07,47%,51%,47,51,-4,2
1740,2011-08-06,47%,52%,47,52,-5,1
1741,2011-08-05,47%,52%,47,52,-5,1
1742,2011-08-04,45%,54%,45,54,-9,1
1743,2011-08-03,44%,54%,44,54,-10,2
1744,2011-08-02,44%,54%,44,54,-10,2
1745,2011-08-01,44%,55%,44,55,-11,1
1746,2011-07-31,44%,55%,44,55,-11,1
1747,2011-07-30,44%,56%,44,56,-12,0
1748,2011-07-29,46%,54%,46,54,-8,0
1749,2011-07-28,44%,55%,44,55,-11,1
1750,2011-07-27,45%,54%,45,54,-9,1
1751,2011-07-26,44%,55%,44,55,-11,1
1752,2011-07-25,44%,55%,44,55,-11,1
1753,2011-07-24,45%,54%,45,54,-9,1
1754,2011-07-23,45%,54%,45,54,-9,1
1755,2011-07-22,46%,52%,46,52,-6,2
1756,2011-07-21,45%,53%,45,53,-8,2
1757,2011-07-20,44%,54%,44,54,-10,2
1758,2011-07-19,44%,54%,44,54,-10,2
1759,2011-07-18,45%,54%,45,54,-9,1
1760,2011-07-17,45%,54%,45,54,-9,1
1761,2011-07-16,47%,52%,47,52,-5,1
1762,2011-07-15,48%,51%,48,51,-3,1
1763,2011-07-14,49%,50%,49,50,-1,1
1764,2011-07-13,48%,51%,48,51,-3,1
1765,2011-07-12,47%,52%,47,52,-5,1
1766,2011-07-11,47%,52%,47,52,-5,1
1767,2011-07-10,46%,53%,46,53,-7,1
1768,2011-07-09,46%,53%,46,53,-7,1
1769,2011-07-08,47%,52%,47,52,-5,1
1770,2011-07-07,48%,50%,48,50,-2,2
1771,2011-07-06,49%,50%,49,50,-1,1
1772,2011-07-03,49%,50%,49,50,-1,1
1773,2011-07-02,49%,50%,49,50,-1,1
1774,2011-07-01,47%,52%,47,52,-5,1
1775,2011-06-30,47%,52%,47,52,-5,1
1776,2011-06-29,47%,52%,47,52,-5,1
1777,2011-06-28,49%,50%,49,50,-1,1
1778,2011-06-27,49%,51%,49,51,-2,0
1779,2011-06-26,48%,51%,48,51,-3,1
1780,2011-06-25,46%,53%,46,53,-7,1
1781,2011-06-24,46%,53%,46,53,-7,1
1782,2011-06-23,46%,53%,46,53,-7,1
1783,2011-06-22,46%,52%,46,52,-6,2
1784,2011-06-21,47%,50%,47,50,-3,3
1785,2011-06-20,47%,51%,47,51,-4,2
1786,2011-06-19,47%,52%,47,52,-5,1
1787,2011-06-18,45%,55%,45,55,-10,0
1788,2011-06-17,46%,54%,46,54,-8,0
1789,2011-06-16,45%,54%,45,54,-9,1
1790,2011-06-15,47%,53%,47,53,-6,0
1791,2011-06-14,46%,54%,46,54,-8,0
1792,2011-06-13,47%,52%,47,52,-5,1
1793,2011-06-12,47%,53%,47,53,-6,0
1794,2011-06-11,48%,51%,48,51,-3,1
1795,2011-06-10,47%,53%,47,53,-6,0
1796,2011-06-09,50%,49%,50,49,1,1
1797,2011-06-08,48%,51%,48,51,-3,1
1798,2011-06-07,49%,50%,49,50,-1,1
1799,2011-06-06,48%,51%,48,51,-3,1
1800,2011-06-05,50%,50%,50,50,0,0
1801,2011-06-04,49%,50%,49,50,-1,1
1802,2011-06-03,49%,50%,49,50,-1,1
1803,2011-06-02,49%,50%,49,50,-1,1
1804,2011-06-01,49%,50%,49,50,-1,1
1805,2011-05-31,48%,51%,48,51,-3,1
1806,2011-05-30,49%,49%,49,49,0,2
1807,2011-05-29,50%,49%,50,49,1,1
1808,2011-05-28,50%,49%,50,49,1,1
1809,2011-05-27,49%,49%,49,49,0,2
1810,2011-05-26,50%,48%,50,48,2,2
1811,2011-05-25,50%,48%,50,48,2,2
1812,2011-05-24,51%,48%,51,48,3,1
1813,2011-05-23,49%,50%,49,50,-1,1
1814,2011-05-22,49%,50%,49,50,-1,1
1815,2011-05-21,48%,50%,48,50,-2,2
1816,2011-05-20,49%,50%,49,50,-1,1
1817,2011-05-19,49%,50%,49,50,-1,1
1818,2011-05-18,50%,49%,50,49,1,1
1819,2011-05-17,50%,49%,50,49,1,1
1820,2011-05-16,49%,50%,49,50,-1,1
1821,2011-05-15,48%,51%,48,51,-3,1
1822,2011-05-14,48%,51%,48,51,-3,1
1823,2011-05-13,47%,52%,47,52,-5,1
1824,2011-05-12,47%,52%,47,52,-5,1
1825,2011-05-11,48%,52%,48,52,-4,0
1826,2011-05-10,50%,49%,50,49,1,1
1827,2011-05-08,51%,48%,51,48,3,1
1828,2011-05-07,51%,48%,51,48,3,1
1829,2011-05-06,50%,49%,50,49,1,1
1830,2011-05-05,49%,50%,49,50,-1,1
1831,2011-05-04,48%,51%,48,51,-3,1
1832,2011-05-03,49%,50%,49,50,-1,1
1833,2011-05-02,49%,49%,49,49,0,2
1834,2011-05-01,50%,49%,50,49,1,1
1835,2011-04-30,49%,50%,49,50,-1,1
1836,2011-04-29,48%,51%,48,51,-3,1
1837,2011-04-28,47%,52%,47,52,-5,1
1838,2011-04-27,46%,52%,46,52,-6,2
1839,2011-04-26,46%,53%,46,53,-7,1
1840,2011-04-25,46%,52%,46,52,-6,2
1841,2011-04-24,48%,52%,48,52,-4,0
1842,2011-04-23,48%,51%,48,51,-3,1
1843,2011-04-22,47%,53%,47,53,-6,0
1844,2011-04-21,46%,53%,46,53,-7,1
1845,2011-04-20,46%,53%,46,53,-7,1
1846,2011-04-19,48%,51%,48,51,-3,1
1847,2011-04-18,47%,52%,47,52,-5,1
1848,2011-04-17,48%,51%,48,51,-3,1
1849,2011-04-16,46%,53%,46,53,-7,1
1850,2011-04-15,48%,51%,48,51,-3,1
1851,2011-04-14,49%,50%,49,50,-1,1
1852,2011-04-13,48%,51%,48,51,-3,1
1853,2011-04-12,46%,54%,46,54,-8,0
1854,2011-04-11,44%,55%,44,55,-11,1
1855,2011-04-10,45%,54%,45,54,-9,1
1856,2011-04-09,46%,53%,46,53,-7,1
1857,2011-04-08,47%,52%,47,52,-5,1
1858,2011-04-07,47%,52%,47,52,-5,1
1859,2011-04-06,48%,51%,48,51,-3,1
1860,2011-04-05,47%,52%,47,52,-5,1
1861,2011-04-04,48%,51%,48,51,-3,1
1862,2011-04-03,45%,53%,45,53,-8,2
1863,2011-04-02,47%,52%,47,52,-5,1
1864,2011-04-01,45%,54%,45,54,-9,1
1865,2011-03-31,44%,55%,44,55,-11,1
1866,2011-03-30,43%,56%,43,56,-13,1
1867,2011-03-29,43%,56%,43,56,-13,1
1868,2011-03-28,47%,52%,47,52,-5,1
1869,2011-03-27,46%,53%,46,53,-7,1
1870,2011-03-26,47%,52%,47,52,-5,1
1871,2011-03-25,47%,52%,47,52,-5,1
1872,2011-03-24,48%,52%,48,52,-4,0
1873,2011-03-23,47%,52%,47,52,-5,1
1874,2011-03-22,46%,53%,46,53,-7,1
1875,2011-03-21,46%,54%,46,54,-8,0
1876,2011-03-20,46%,54%,46,54,-8,0
1877,2011-03-19,46%,54%,46,54,-8,0
1878,2011-03-18,45%,54%,45,54,-9,1
1879,2011-03-17,44%,55%,44,55,-11,1
1880,2011-03-16,42%,56%,42,56,-14,2
1881,2011-03-15,43%,57%,43,57,-14,0
1882,2011-03-14,44%,56%,44,56,-12,0
1883,2011-03-13,45%,54%,45,54,-9,1
1884,2011-03-12,47%,52%,47,52,-5,1
1885,2011-03-11,46%,53%,46,53,-7,1
1886,2011-03-10,47%,52%,47,52,-5,1
1887,2011-03-09,47%,52%,47,52,-5,1
1888,2011-03-08,49%,51%,49,51,-2,0
1889,2011-03-07,48%,52%,48,52,-4,0
1890,2011-03-06,47%,52%,47,52,-5,1
1891,2011-03-05,47%,52%,47,52,-5,1
1892,2011-03-04,46%,53%,46,53,-7,1
1893,2011-03-03,45%,54%,45,54,-9,1
1894,2011-03-02,45%,53%,45,53,-8,2
1895,2011-03-01,48%,51%,48,51,-3,1
1896,2011-02-28,49%,50%,49,50,-1,1
1897,2011-02-27,49%,51%,49,51,-2,0
1898,2011-02-26,47%,53%,47,53,-6,0
1899,2011-02-25,48%,52%,48,52,-4,0
1900,2011-02-24,47%,53%,47,53,-6,0
1901,2011-02-23,46%,53%,46,53,-7,1
1902,2011-02-22,44%,55%,44,55,-11,1
1903,2011-02-21,44%,55%,44,55,-11,1
1904,2011-02-20,44%,54%,44,54,-10,2
1905,2011-02-19,45%,53%,45,53,-8,2
1906,2011-02-18,46%,52%,46,52,-6,2
1907,2011-02-17,48%,50%,48,50,-2,2
1908,2011-02-16,48%,51%,48,51,-3,1
1909,2011-02-15,48%,51%,48,51,-3,1
1910,2011-02-14,48%,52%,48,52,-4,0
1911,2011-02-13,48%,51%,48,51,-3,1
1912,2011-02-12,48%,51%,48,51,-3,1
1913,2011-02-11,50%,49%,50,49,1,1
1914,2011-02-10,50%,50%,50,50,0,0
1915,2011-02-09,50%,49%,50,49,1,1
1916,2011-02-08,49%,50%,49,50,-1,1
1917,2011-02-07,49%,50%,49,50,-1,1
1918,2011-02-06,48%,51%,48,51,-3,1
1919,2011-02-05,46%,53%,46,53,-7,1
1920,2011-02-04,46%,53%,46,53,-7,1
1921,2011-02-03,47%,53%,47,53,-6,0
1922,2011-02-02,49%,50%,49,50,-1,1
1923,2011-02-01,50%,49%,50,49,1,1
1924,2011-01-31,50%,49%,50,49,1,1
1925,2011-01-30,50%,48%,50,48,2,2
1926,2011-01-29,49%,49%,49,49,0,2
1927,2011-01-28,49%,50%,49,50,-1,1
1928,2011-01-27,47%,51%,47,51,-4,2
1929,2011-01-26,50%,48%,50,48,2,2
1930,2011-01-25,52%,47%,52,47,5,1
1931,2011-01-24,52%,47%,52,47,5,1
1932,2011-01-23,50%,49%,50,49,1,1
1933,2011-01-22,50%,48%,50,48,2,2
1934,2011-01-21,49%,49%,49,49,0,2
1935,2011-01-20,49%,50%,49,50,-1,1
1936,2011-01-19,48%,51%,48,51,-3,1
1937,2011-01-18,48%,51%,48,51,-3,1
1938,2011-01-17,46%,53%,46,53,-7,1
1939,2011-01-16,44%,55%,44,55,-11,1
1940,2011-01-15,46%,53%,46,53,-7,1
1941,2011-01-14,47%,51%,47,51,-4,2
1942,2011-01-13,49%,50%,49,50,-1,1
1943,2011-01-12,48%,51%,48,51,-3,1
1944,2011-01-11,49%,51%,49,51,-2,0
1945,2011-01-10,48%,51%,48,51,-3,1
1946,2011-01-09,48%,50%,48,50,-2,2
1947,2011-01-08,48%,50%,48,50,-2,2
1948,2011-01-07,48%,50%,48,50,-2,2
1949,2011-01-06,46%,53%,46,53,-7,1
1950,2011-01-05,46%,54%,46,54,-8,0
1951,2011-01-04,47%,53%,47,53,-6,0
1952,2011-01-03,47%,52%,47,52,-5,1
1953,2010-12-31,48%,51%,48,51,-3,1
1954,2010-12-30,46%,53%,46,53,-7,1
1955,2010-12-29,48%,51%,48,51,-3,1
1956,2010-12-28,47%,51%,47,51,-4,2
1957,2010-12-27,48%,51%,48,51,-3,1
1958,2010-12-24,46%,53%,46,53,-7,1
1959,2010-12-23,47%,51%,47,51,-4,2
1960,2010-12-22,48%,51%,48,51,-3,1
1961,2010-12-21,50%,49%,50,49,1,1
1962,2010-12-20,49%,50%,49,50,-1,1
1963,2010-12-19,46%,53%,46,53,-7,1
1964,2010-12-18,44%,55%,44,55,-11,1
1965,2010-12-17,44%,55%,44,55,-11,1
1966,2010-12-16,47%,53%,47,53,-6,0
1967,2010-12-15,45%,54%,45,54,-9,1
1968,2010-12-14,45%,54%,45,54,-9,1
1969,2010-12-13,44%,55%,44,55,-11,1
1970,2010-12-12,45%,53%,45,53,-8,2
1971,2010-12-11,46%,53%,46,53,-7,1
1972,2010-12-10,46%,53%,46,53,-7,1
1973,2010-12-09,46%,53%,46,53,-7,1
1974,2010-12-08,46%,53%,46,53,-7,1
1975,2010-12-07,47%,52%,47,52,-5,1
1976,2010-12-06,47%,53%,47,53,-6,0
1977,2010-12-05,46%,54%,46,54,-8,0
1978,2010-12-04,43%,56%,43,56,-13,1
1979,2010-12-03,44%,55%,44,55,-11,1
1980,2010-12-02,44%,54%,44,54,-10,2
1981,2010-12-01,46%,53%,46,53,-7,1
1982,2010-11-30,46%,53%,46,53,-7,1
1983,2010-11-29,47%,52%,47,52,-5,1
1984,2010-11-24,48%,51%,48,51,-3,1
1985,2010-11-23,47%,52%,47,52,-5,1
1986,2010-11-22,46%,52%,46,52,-6,2
1987,2010-11-21,47%,51%,47,51,-4,2
1988,2010-11-20,47%,51%,47,51,-4,2
1989,2010-11-19,47%,52%,47,52,-5,1
1990,2010-11-18,45%,54%,45,54,-9,1
1991,2010-11-17,44%,55%,44,55,-11,1
1992,2010-11-16,45%,54%,45,54,-9,1
1993,2010-11-15,46%,53%,46,53,-7,1
1994,2010-11-14,47%,52%,47,52,-5,1
1995,2010-11-13,46%,53%,46,53,-7,1
1996,2010-11-12,44%,54%,44,54,-10,2
1997,2010-11-11,44%,54%,44,54,-10,2
1998,2010-11-10,45%,54%,45,54,-9,1
1999,2010-11-09,45%,54%,45,54,-9,1
2000,2010-11-08,47%,53%,47,53,-6,0
2001,2010-11-07,46%,54%,46,54,-8,0
2002,2010-11-06,46%,53%,46,53,-7,1
2003,2010-11-05,45%,54%,45,54,-9,1
2004,2010-11-04,45%,54%,45,54,-9,1
2005,2010-11-03,48%,52%,48,52,-4,0
2006,2010-11-02,48%,51%,48,51,-3,1
2007,2010-11-01,50%,49%,50,49,1,1
2008,2010-10-31,47%,52%,47,52,-5,1
2009,2010-10-30,45%,53%,45,53,-8,2
2010,2010-10-29,44%,55%,44,55,-11,1
2011,2010-10-28,44%,55%,44,55,-11,1
2012,2010-10-27,46%,54%,46,54,-8,0
2013,2010-10-26,47%,52%,47,52,-5,1
2014,2010-10-25,47%,53%,47,53,-6,0
2015,2010-10-24,47%,53%,47,53,-6,0
2016,2010-10-23,45%,54%,45,54,-9,1
2017,2010-10-22,46%,53%,46,53,-7,1
2018,2010-10-21,47%,52%,47,52,-5,1
2019,2010-10-20,47%,52%,47,52,-5,1
2020,2010-10-19,49%,50%,49,50,-1,1
2021,2010-10-18,49%,50%,49,50,-1,1
2022,2010-10-17,47%,52%,47,52,-5,1
2023,2010-10-16,43%,56%,43,56,-13,1
2024,2010-10-15,43%,56%,43,56,-13,1
2025,2010-10-14,44%,55%,44,55,-11,1
2026,2010-10-13,45%,54%,45,54,-9,1
2027,2010-10-12,47%,52%,47,52,-5,1
2028,2010-10-11,48%,51%,48,51,-3,1
2029,2010-10-10,49%,50%,49,50,-1,1
2030,2010-10-09,48%,51%,48,51,-3,1
2031,2010-10-08,47%,52%,47,52,-5,1
2032,2010-10-07,46%,53%,46,53,-7,1
2033,2010-10-06,48%,52%,48,52,-4,0
2034,2010-10-05,48%,51%,48,51,-3,1
2035,2010-10-04,48%,51%,48,51,-3,1
2036,2010-10-03,48%,52%,48,52,-4,0
2037,2010-10-02,47%,53%,47,53,-6,0
2038,2010-10-01,45%,54%,45,54,-9,1
2039,2010-09-30,45%,55%,45,55,-10,0
2040,2010-09-29,46%,52%,46,52,-6,2
2041,2010-09-28,50%,49%,50,49,1,1
2042,2010-09-27,48%,51%,48,51,-3,1
2043,2010-09-26,47%,52%,47,52,-5,1
2044,2010-09-25,45%,54%,45,54,-9,1
2045,2010-09-24,47%,52%,47,52,-5,1
2046,2010-09-23,48%,51%,48,51,-3,1
2047,2010-09-22,47%,52%,47,52,-5,1
2048,2010-09-21,44%,55%,44,55,-11,1
2049,2010-09-20,44%,56%,44,56,-12,0
2050,2010-09-19,45%,55%,45,55,-10,0
2051,2010-09-18,45%,55%,45,55,-10,0
2052,2010-09-17,45%,55%,45,55,-10,0
2053,2010-09-16,45%,54%,45,54,-9,1
2054,2010-09-15,47%,53%,47,53,-6,0
2055,2010-09-14,47%,52%,47,52,-5,1
2056,2010-09-13,46%,53%,46,53,-7,1
2057,2010-09-12,46%,54%,46,54,-8,0
2058,2010-09-11,42%,57%,42,57,-15,1
2059,2010-09-10,42%,56%,42,56,-14,2
2060,2010-09-09,41%,58%,41,58,-17,1
2061,2010-09-08,45%,54%,45,54,-9,1
2062,2010-09-07,45%,55%,45,55,-10,0
2063,2010-09-06,45%,54%,45,54,-9,1
2064,2010-09-05,42%,57%,42,57,-15,1
2065,2010-09-04,42%,56%,42,56,-14,2
2066,2010-09-03,44%,55%,44,55,-11,1
2067,2010-09-02,47%,52%,47,52,-5,1
2068,2010-09-01,48%,51%,48,51,-3,1
2069,2010-08-31,48%,51%,48,51,-3,1
2070,2010-08-30,46%,52%,46,52,-6,2
2071,2010-08-29,46%,52%,46,52,-6,2
2072,2010-08-28,47%,52%,47,52,-5,1
2073,2010-08-27,46%,54%,46,54,-8,0
2074,2010-08-26,44%,56%,44,56,-12,0
2075,2010-08-25,44%,56%,44,56,-12,0
2076,2010-08-24,45%,54%,45,54,-9,1
2077,2010-08-23,47%,52%,47,52,-5,1
2078,2010-08-22,48%,51%,48,51,-3,1
2079,2010-08-21,45%,53%,45,53,-8,2
2080,2010-08-20,45%,54%,45,54,-9,1
2081,2010-08-19,46%,53%,46,53,-7,1
2082,2010-08-18,45%,54%,45,54,-9,1
2083,2010-08-17,44%,55%,44,55,-11,1
2084,2010-08-16,43%,56%,43,56,-13,1
2085,2010-08-15,45%,53%,45,53,-8,2
2086,2010-08-14,46%,53%,46,53,-7,1
2087,2010-08-13,47%,52%,47,52,-5,1
2088,2010-08-12,45%,54%,45,54,-9,1
2089,2010-08-11,43%,56%,43,56,-13,1
2090,2010-08-10,44%,55%,44,55,-11,1
2091,2010-08-09,46%,52%,46,52,-6,2
2092,2010-08-08,48%,51%,48,51,-3,1
2093,2010-08-07,48%,51%,48,51,-3,1
2094,2010-08-06,47%,53%,47,53,-6,0
2095,2010-08-05,46%,54%,46,54,-8,0
2096,2010-08-04,46%,53%,46,53,-7,1
2097,2010-08-03,46%,53%,46,53,-7,1
2098,2010-08-02,45%,54%,45,54,-9,1
2099,2010-08-01,44%,55%,44,55,-11,1
2100,2010-07-31,44%,56%,44,56,-12,0
2101,2010-07-30,47%,53%,47,53,-6,0
2102,2010-07-29,46%,54%,46,54,-8,0
2103,2010-07-28,46%,53%,46,53,-7,1
2104,2010-07-27,44%,56%,44,56,-12,0
2105,2010-07-26,45%,55%,45,55,-10,0
2106,2010-07-25,43%,56%,43,56,-13,1
2107,2010-07-24,43%,56%,43,56,-13,1
2108,2010-07-23,43%,56%,43,56,-13,1
2109,2010-07-22,44%,55%,44,55,-11,1
2110,2010-07-21,46%,53%,46,53,-7,1
2111,2010-07-20,46%,53%,46,53,-7,1
2112,2010-07-19,47%,52%,47,52,-5,1
2113,2010-07-18,46%,54%,46,54,-8,0
2114,2010-07-17,44%,55%,44,55,-11,1
2115,2010-07-16,46%,54%,46,54,-8,0
2116,2010-07-15,45%,54%,45,54,-9,1
2117,2010-07-14,47%,53%,47,53,-6,0
2118,2010-07-13,48%,52%,48,52,-4,0
2119,2010-07-12,49%,50%,49,50,-1,1
2120,2010-07-11,49%,50%,49,50,-1,1
2121,2010-07-10,47%,52%,47,52,-5,1
2122,2010-07-09,46%,53%,46,53,-7,1
2123,2010-07-08,45%,54%,45,54,-9,1
2124,2010-07-07,45%,54%,45,54,-9,1
2125,2010-07-06,45%,54%,45,54,-9,1
2126,2010-07-02,45%,55%,45,55,-10,0
2127,2010-07-01,44%,55%,44,55,-11,1
2128,2010-06-30,45%,54%,45,54,-9,1
2129,2010-06-29,48%,51%,48,51,-3,1
2130,2010-06-28,49%,50%,49,50,-1,1
2131,2010-06-27,45%,54%,45,54,-9,1
2132,2010-06-26,45%,54%,45,54,-9,1
2133,2010-06-25,45%,53%,45,53,-8,2
2134,2010-06-24,48%,51%,48,51,-3,1
2135,2010-06-23,48%,51%,48,51,-3,1
2136,2010-06-22,46%,53%,46,53,-7,1
2137,2010-06-21,45%,55%,45,55,-10,0
2138,2010-06-20,43%,57%,43,57,-14,0
2139,2010-06-19,42%,57%,42,57,-15,1
2140,2010-06-18,41%,58%,41,58,-17,1
2141,2010-06-17,43%,56%,43,56,-13,1
2142,2010-06-16,42%,57%,42,57,-15,1
2143,2010-06-15,45%,54%,45,54,-9,1
2144,2010-06-14,45%,55%,45,55,-10,0
2145,2010-06-13,47%,52%,47,52,-5,1
2146,2010-06-12,46%,54%,46,54,-8,0
2147,2010-06-11,46%,54%,46,54,-8,0
2148,2010-06-10,46%,53%,46,53,-7,1
2149,2010-06-09,46%,53%,46,53,-7,1
2150,2010-06-08,49%,50%,49,50,-1,1
2151,2010-06-07,46%,53%,46,53,-7,1
2152,2010-06-06,46%,54%,46,54,-8,0
2153,2010-06-05,45%,54%,45,54,-9,1
2154,2010-06-04,48%,52%,48,52,-4,0
2155,2010-06-03,48%,52%,48,52,-4,0
2156,2010-06-02,46%,53%,46,53,-7,1
2157,2010-06-01,46%,54%,46,54,-8,0
2158,2010-05-31,46%,54%,46,54,-8,0
2159,2010-05-30,47%,53%,47,53,-6,0
2160,2010-05-29,48%,52%,48,52,-4,0
2161,2010-05-28,48%,51%,48,51,-3,1
2162,2010-05-27,45%,53%,45,53,-8,2
2163,2010-05-26,43%,56%,43,56,-13,1
2164,2010-05-25,42%,56%,42,56,-14,2
2165,2010-05-24,44%,55%,44,55,-11,1
2166,2010-05-23,45%,54%,45,54,-9,1
2167,2010-05-22,48%,52%,48,52,-4,0
2168,2010-05-21,46%,53%,46,53,-7,1
2169,2010-05-20,45%,53%,45,53,-8,2
2170,2010-05-19,44%,55%,44,55,-11,1
2171,2010-05-18,45%,53%,45,53,-8,2
2172,2010-05-17,46%,53%,46,53,-7,1
2173,2010-05-16,48%,52%,48,52,-4,0
2174,2010-05-15,48%,52%,48,52,-4,0
2175,2010-05-14,46%,53%,46,53,-7,1
2176,2010-05-13,46%,53%,46,53,-7,1
2177,2010-05-12,47%,52%,47,52,-5,1
2178,2010-05-11,48%,51%,48,51,-3,1
2179,2010-05-09,47%,52%,47,52,-5,1
2180,2010-05-08,46%,53%,46,53,-7,1
2181,2010-05-07,45%,54%,45,54,-9,1
2182,2010-05-06,47%,52%,47,52,-5,1
2183,2010-05-05,48%,52%,48,52,-4,0
2184,2010-05-04,48%,51%,48,51,-3,1
2185,2010-05-03,48%,51%,48,51,-3,1
2186,2010-05-02,48%,51%,48,51,-3,1
2187,2010-05-01,46%,53%,46,53,-7,1
2188,2010-04-30,47%,53%,47,53,-6,0
2189,2010-04-29,47%,52%,47,52,-5,1
2190,2010-04-28,47%,52%,47,52,-5,1
2191,2010-04-27,47%,52%,47,52,-5,1
2192,2010-04-26,47%,52%,47,52,-5,1
2193,2010-04-25,45%,54%,45,54,-9,1
2194,2010-04-24,47%,52%,47,52,-5,1
2195,2010-04-23,47%,52%,47,52,-5,1
2196,2010-04-22,47%,52%,47,52,-5,1
2197,2010-04-21,47%,52%,47,52,-5,1
2198,2010-04-20,49%,50%,49,50,-1,1
2199,2010-04-19,48%,51%,48,51,-3,1
2200,2010-04-18,47%,52%,47,52,-5,1
2201,2010-04-17,45%,54%,45,54,-9,1
2202,2010-04-16,47%,52%,47,52,-5,1
2203,2010-04-15,48%,51%,48,51,-3,1
2204,2010-04-14,50%,49%,50,49,1,1
2205,2010-04-13,49%,50%,49,50,-1,1
2206,2010-04-12,48%,51%,48,51,-3,1
2207,2010-04-11,47%,53%,47,53,-6,0
2208,2010-04-10,48%,52%,48,52,-4,0
2209,2010-04-09,48%,52%,48,52,-4,0
2210,2010-04-08,47%,53%,47,53,-6,0
2211,2010-04-07,48%,52%,48,52,-4,0
2212,2010-04-06,48%,51%,48,51,-3,1
2213,2010-04-05,49%,51%,49,51,-2,0
2214,2010-04-04,46%,53%,46,53,-7,1
2215,2010-04-03,46%,53%,46,53,-7,1
2216,2010-04-02,46%,53%,46,53,-7,1
2217,2010-04-01,47%,53%,47,53,-6,0
2218,2010-03-31,48%,51%,48,51,-3,1
2219,2010-03-30,47%,53%,47,53,-6,0
2220,2010-03-29,47%,52%,47,52,-5,1
2221,2010-03-28,47%,53%,47,53,-6,0
2222,2010-03-27,47%,53%,47,53,-6,0
2223,2010-03-26,49%,51%,49,51,-2,0
2224,2010-03-25,48%,51%,48,51,-3,1
2225,2010-03-24,48%,52%,48,52,-4,0
2226,2010-03-23,48%,52%,48,52,-4,0
2227,2010-03-22,47%,53%,47,53,-6,0
2228,2010-03-21,45%,54%,45,54,-9,1
2229,2010-03-20,43%,56%,43,56,-13,1
2230,2010-03-19,45%,55%,45,55,-10,0
2231,2010-03-18,45%,55%,45,55,-10,0
2232,2010-03-17,44%,55%,44,55,-11,1
2233,2010-03-16,45%,54%,45,54,-9,1
2234,2010-03-15,45%,54%,45,54,-9,1
2235,2010-03-14,46%,53%,46,53,-7,1
2236,2010-03-13,45%,54%,45,54,-9,1
2237,2010-03-12,44%,54%,44,54,-10,2
2238,2010-03-11,44%,54%,44,54,-10,2
2239,2010-03-10,43%,56%,43,56,-13,1
2240,2010-03-09,44%,54%,44,54,-10,2
2241,2010-03-08,46%,54%,46,54,-8,0
2242,2010-03-07,48%,52%,48,52,-4,0
2243,2010-03-06,45%,54%,45,54,-9,1
2244,2010-03-05,46%,53%,46,53,-7,1
2245,2010-03-04,46%,54%,46,54,-8,0
2246,2010-03-03,47%,53%,47,53,-6,0
2247,2010-03-02,47%,52%,47,52,-5,1
2248,2010-03-01,47%,52%,47,52,-5,1
2249,2010-02-28,45%,54%,45,54,-9,1
2250,2010-02-27,43%,55%,43,55,-12,2
2251,2010-02-26,44%,55%,44,55,-11,1
2252,2010-02-25,45%,54%,45,54,-9,1
2253,2010-02-24,45%,54%,45,54,-9,1
2254,2010-02-23,45%,54%,45,54,-9,1
2255,2010-02-22,45%,54%,45,54,-9,1
2256,2010-02-21,45%,54%,45,54,-9,1
2257,2010-02-20,45%,53%,45,53,-8,2
2258,2010-02-19,48%,51%,48,51,-3,1
2259,2010-02-18,49%,50%,49,50,-1,1
2260,2010-02-17,50%,50%,50,50,0,0
2261,2010-02-16,49%,51%,49,51,-2,0
2262,2010-02-15,47%,52%,47,52,-5,1
2263,2010-02-14,47%,51%,47,51,-4,2
2264,2010-02-13,45%,53%,45,53,-8,2
2265,2010-02-12,47%,52%,47,52,-5,1
2266,2010-02-11,46%,52%,46,52,-6,2
2267,2010-02-10,48%,51%,48,51,-3,1
2268,2010-02-09,47%,53%,47,53,-6,0
2269,2010-02-08,46%,54%,46,54,-8,0
2270,2010-02-07,44%,56%,44,56,-12,0
2271,2010-02-06,44%,55%,44,55,-11,1
2272,2010-02-05,46%,53%,46,53,-7,1
2273,2010-02-04,49%,50%,49,50,-1,1
2274,2010-02-03,50%,49%,50,49,1,1
2275,2010-02-02,50%,49%,50,49,1,1
2276,2010-02-01,49%,50%,49,50,-1,1
2277,2010-01-31,50%,50%,50,50,0,0
2278,2010-01-30,49%,51%,49,51,-2,0
2279,2010-01-29,47%,52%,47,52,-5,1
2280,2010-01-28,46%,54%,46,54,-8,0
2281,2010-01-27,46%,53%,46,53,-7,1
2282,2010-01-26,47%,53%,47,53,-6,0
2283,2010-01-25,47%,53%,47,53,-6,0
2284,2010-01-24,46%,54%,46,54,-8,0
2285,2010-01-23,44%,55%,44,55,-11,1
2286,2010-01-22,45%,54%,45,54,-9,1
2287,2010-01-21,47%,52%,47,52,-5,1
2288,2010-01-20,48%,51%,48,51,-3,1
2289,2010-01-19,48%,51%,48,51,-3,1
2290,2010-01-18,47%,52%,47,52,-5,1
2291,2010-01-17,48%,51%,48,51,-3,1
2292,2010-01-16,49%,51%,49,51,-2,0
2293,2010-01-15,47%,52%,47,52,-5,1
2294,2010-01-14,46%,53%,46,53,-7,1
2295,2010-01-13,46%,53%,46,53,-7,1
2296,2010-01-12,46%,53%,46,53,-7,1
2297,2010-01-11,46%,52%,46,52,-6,2
2298,2010-01-10,45%,54%,45,54,-9,1
2299,2010-01-09,46%,53%,46,53,-7,1
2300,2010-01-08,46%,54%,46,54,-8,0
2301,2010-01-07,48%,52%,48,52,-4,0
2302,2010-01-06,49%,51%,49,51,-2,0
2303,2010-01-05,49%,51%,49,51,-2,0
2304,2010-01-04,47%,52%,47,52,-5,1
2305,2009-12-31,46%,53%,46,53,-7,1
2306,2009-12-30,47%,52%,47,52,-5,1
2307,2009-12-29,46%,53%,46,53,-7,1
2308,2009-12-28,47%,52%,47,52,-5,1
2309,2009-12-24,44%,56%,44,56,-12,0
2310,2009-12-23,45%,55%,45,55,-10,0
2311,2009-12-22,44%,56%,44,56,-12,0
2312,2009-12-21,46%,53%,46,53,-7,1
2313,2009-12-20,46%,53%,46,53,-7,1
2314,2009-12-19,45%,53%,45,53,-8,2
2315,2009-12-18,44%,54%,44,54,-10,2
2316,2009-12-17,46%,54%,46,54,-8,0
2317,2009-12-16,45%,54%,45,54,-9,1
2318,2009-12-15,46%,53%,46,53,-7,1
2319,2009-12-14,44%,55%,44,55,-11,1
2320,2009-12-13,46%,53%,46,53,-7,1
2321,2009-12-12,46%,53%,46,53,-7,1
2322,2009-12-11,47%,51%,47,51,-4,2
2323,2009-12-10,46%,53%,46,53,-7,1
2324,2009-12-09,48%,52%,48,52,-4,0
2325,2009-12-08,47%,52%,47,52,-5,1
2326,2009-12-07,49%,50%,49,50,-1,1
2327,2009-12-06,47%,52%,47,52,-5,1
2328,2009-12-05,47%,52%,47,52,-5,1
2329,2009-12-04,46%,54%,46,54,-8,0
2330,2009-12-03,46%,54%,46,54,-8,0
2331,2009-12-02,47%,52%,47,52,-5,1
2332,2009-12-01,47%,52%,47,52,-5,1
2333,2009-11-30,47%,52%,47,52,-5,1
2334,2009-11-25,46%,54%,46,54,-8,0
2335,2009-11-24,45%,54%,45,54,-9,1
2336,2009-11-23,46%,53%,46,53,-7,1
2337,2009-11-22,48%,52%,48,52,-4,0
2338,2009-11-21,47%,52%,47,52,-5,1
2339,2009-11-20,47%,52%,47,52,-5,1
2340,2009-11-19,46%,52%,46,52,-6,2
2341,2009-11-18,47%,52%,47,52,-5,1
2342,2009-11-17,49%,51%,49,51,-2,0
2343,2009-11-16,50%,49%,50,49,1,1
2344,2009-11-15,50%,49%,50,49,1,1
2345,2009-11-14,50%,49%,50,49,1,1
2346,2009-11-13,47%,51%,47,51,-4,2
2347,2009-11-12,47%,52%,47,52,-5,1
2348,2009-11-11,46%,53%,46,53,-7,1
2349,2009-11-10,48%,52%,48,52,-4,0
2350,2009-11-09,49%,50%,49,50,-1,1
2351,2009-11-08,49%,50%,49,50,-1,1
2352,2009-11-07,49%,50%,49,50,-1,1
2353,2009-11-06,49%,51%,49,51,-2,0
2354,2009-11-05,48%,52%,48,52,-4,0
2355,2009-11-04,48%,51%,48,51,-3,1
2356,2009-11-03,46%,52%,46,52,-6,2
2357,2009-11-02,46%,52%,46,52,-6,2
2358,2009-11-01,46%,52%,46,52,-6,2
2359,2009-10-31,46%,52%,46,52,-6,2
2360,2009-10-30,47%,52%,47,52,-5,1
2361,2009-10-29,47%,52%,47,52,-5,1
2362,2009-10-28,48%,52%,48,52,-4,0
2363,2009-10-27,49%,51%,49,51,-2,0
2364,2009-10-26,47%,52%,47,52,-5,1
2365,2009-10-25,48%,51%,48,51,-3,1
2366,2009-10-24,47%,51%,47,51,-4,2
2367,2009-10-23,49%,50%,49,50,-1,1
2368,2009-10-22,47%,52%,47,52,-5,1
2369,2009-10-21,47%,53%,47,53,-6,0
2370,2009-10-20,47%,52%,47,52,-5,1
2371,2009-10-19,49%,50%,49,50,-1,1
2372,2009-10-18,49%,50%,49,50,-1,1
2373,2009-10-17,49%,50%,49,50,-1,1
2374,2009-10-16,47%,51%,47,51,-4,2
2375,2009-10-15,48%,51%,48,51,-3,1
2376,2009-10-14,49%,50%,49,50,-1,1
2377,2009-10-13,49%,50%,49,50,-1,1
2378,2009-10-12,49%,51%,49,51,-2,0
2379,2009-10-11,49%,51%,49,51,-2,0
2380,2009-10-10,50%,50%,50,50,0,0
2381,2009-10-09,49%,50%,49,50,-1,1
2382,2009-10-08,48%,51%,48,51,-3,1
2383,2009-10-07,49%,50%,49,50,-1,1
2384,2009-10-06,51%,49%,51,49,2,0
2385,2009-10-05,52%,48%,52,48,4,0
2386,2009-10-04,49%,50%,49,50,-1,1
2387,2009-10-03,48%,51%,48,51,-3,1
2388,2009-10-02,48%,51%,48,51,-3,1
2389,2009-10-01,50%,50%,50,50,0,0
2390,2009-09-30,49%,51%,49,51,-2,0
2391,2009-09-29,49%,50%,49,50,-1,1
2392,2009-09-28,49%,51%,49,51,-2,0
2393,2009-09-27,48%,51%,48,51,-3,1
2394,2009-09-26,50%,49%,50,49,1,1
2395,2009-09-25,51%,48%,51,48,3,1
2396,2009-09-24,51%,48%,51,48,3,1
2397,2009-09-23,50%,49%,50,49,1,1
2398,2009-09-22,49%,50%,49,50,-1,1
2399,2009-09-21,49%,50%,49,50,-1,1
2400,2009-09-20,49%,50%,49,50,-1,1
2401,2009-09-19,49%,50%,49,50,-1,1
2402,2009-09-18,48%,51%,48,51,-3,1
2403,2009-09-17,47%,52%,47,52,-5,1
2404,2009-09-16,49%,51%,49,51,-2,0
2405,2009-09-15,50%,50%,50,50,0,0
2406,2009-09-14,52%,48%,52,48,4,0
2407,2009-09-13,51%,48%,51,48,3,1
2408,2009-09-12,50%,49%,50,49,1,1
2409,2009-09-11,49%,50%,49,50,-1,1
2410,2009-09-10,48%,51%,48,51,-3,1
2411,2009-09-09,50%,50%,50,50,0,0
2412,2009-09-08,50%,49%,50,49,1,1
2413,2009-09-07,48%,51%,48,51,-3,1
2414,2009-09-06,49%,50%,49,50,-1,1
2415,2009-09-05,49%,51%,49,51,-2,0
2416,2009-09-04,48%,52%,48,52,-4,0
2417,2009-09-03,47%,53%,47,53,-6,0
2418,2009-09-02,46%,53%,46,53,-7,1
2419,2009-09-01,45%,53%,45,53,-8,2
2420,2009-08-31,46%,53%,46,53,-7,1
2421,2009-08-30,47%,52%,47,52,-5,1
2422,2009-08-29,50%,50%,50,50,0,0
2423,2009-08-28,50%,49%,50,49,1,1
2424,2009-08-27,50%,49%,50,49,1,1
2425,2009-08-26,49%,50%,49,50,-1,1
2426,2009-08-25,49%,51%,49,51,-2,0
2427,2009-08-24,49%,50%,49,50,-1,1
2428,2009-08-23,48%,51%,48,51,-3,1
2429,2009-08-22,49%,50%,49,50,-1,1
2430,2009-08-21,49%,50%,49,50,-1,1
2431,2009-08-20,50%,50%,50,50,0,0
2432,2009-08-19,51%,49%,51,49,2,0
2433,2009-08-18,49%,50%,49,50,-1,1
2434,2009-08-17,49%,50%,49,50,-1,1
2435,2009-08-16,47%,52%,47,52,-5,1
2436,2009-08-15,48%,52%,48,52,-4,0
2437,2009-08-14,48%,51%,48,51,-3,1
2438,2009-08-13,47%,52%,47,52,-5,1
2439,2009-08-12,48%,52%,48,52,-4,0
2440,2009-08-11,49%,50%,49,50,-1,1
2441,2009-08-10,49%,51%,49,51,-2,0
2442,2009-08-09,50%,50%,50,50,0,0
2443,2009-08-08,50%,50%,50,50,0,0
2444,2009-08-07,50%,49%,50,49,1,1
2445,2009-08-06,49%,51%,49,51,-2,0
2446,2009-08-05,49%,51%,49,51,-2,0
2447,2009-08-04,50%,48%,50,48,2,2
2448,2009-08-03,51%,48%,51,48,3,1
2449,2009-08-02,50%,49%,50,49,1,1
2450,2009-08-01,50%,49%,50,49,1,1
2451,2009-07-31,48%,51%,48,51,-3,1
2452,2009-07-30,48%,51%,48,51,-3,1
2453,2009-07-29,49%,50%,49,50,-1,1
2454,2009-07-28,49%,49%,49,49,0,2
2455,2009-07-27,49%,50%,49,50,-1,1
2456,2009-07-26,49%,50%,49,50,-1,1
2457,2009-07-25,49%,51%,49,51,-2,0
2458,2009-07-24,49%,51%,49,51,-2,0
2459,2009-07-23,51%,48%,51,48,3,1
2460,2009-07-22,51%,47%,51,47,4,2
2461,2009-07-21,51%,47%,51,47,4,2
2462,2009-07-20,50%,49%,50,49,1,1
2463,2009-07-19,51%,49%,51,49,2,0
2464,2009-07-18,51%,48%,51,48,3,1
2465,2009-07-17,52%,47%,52,47,5,1
2466,2009-07-16,51%,47%,51,47,4,2
2467,2009-07-15,52%,47%,52,47,5,1
2468,2009-07-14,53%,46%,53,46,7,1
2469,2009-07-13,53%,46%,53,46,7,1
2470,2009-07-12,52%,46%,52,46,6,2
2471,2009-07-11,51%,48%,51,48,3,1
2472,2009-07-10,51%,48%,51,48,3,1
2473,2009-07-09,51%,48%,51,48,3,1
2474,2009-07-08,52%,48%,52,48,4,0
2475,2009-07-07,52%,47%,52,47,5,1
2476,2009-07-06,53%,46%,53,46,7,1
2477,2009-07-02,53%,46%,53,46,7,1
2478,2009-07-01,54%,45%,54,45,9,1
2479,2009-06-30,54%,46%,54,46,8,0
2480,2009-06-29,55%,44%,55,44,11,1
2481,2009-06-28,54%,45%,54,45,9,1
2482,2009-06-27,55%,44%,55,44,11,1
2483,2009-06-26,55%,44%,55,44,11,1
2484,2009-06-25,56%,44%,56,44,12,0
2485,2009-06-24,55%,44%,55,44,11,1
2486,2009-06-23,55%,44%,55,44,11,1
2487,2009-06-22,54%,45%,54,45,9,1
2488,2009-06-21,53%,46%,53,46,7,1
2489,2009-06-20,54%,46%,54,46,8,0
2490,2009-06-19,54%,45%,54,45,9,1
2491,2009-06-18,55%,45%,55,45,10,0
2492,2009-06-17,56%,43%,56,43,13,1
2493,2009-06-16,56%,43%,56,43,13,1
2494,2009-06-15,55%,44%,55,44,11,1
2495,2009-06-14,54%,45%,54,45,9,1
2496,2009-06-13,54%,46%,54,46,8,0
2497,2009-06-12,54%,45%,54,45,9,1
2498,2009-06-11,56%,43%,56,43,13,1
2499,2009-06-10,57%,42%,57,42,15,1
2500,2009-06-09,58%,41%,58,41,17,1
2501,2009-06-08,56%,43%,56,43,13,1
2502,2009-06-07,53%,46%,53,46,7,1
2503,2009-06-06,53%,47%,53,47,6,0
2504,2009-06-05,54%,46%,54,46,8,0
2505,2009-06-04,55%,45%,55,45,10,0
2506,2009-06-03,55%,44%,55,44,11,1
2507,2009-06-02,58%,41%,58,41,17,1
2508,2009-06-01,58%,41%,58,41,17,1
2509,2009-05-31,58%,41%,58,41,17,1
2510,2009-05-30,58%,41%,58,41,17,1
2511,2009-05-29,59%,40%,59,40,19,1
2512,2009-05-28,56%,43%,56,43,13,1
2513,2009-05-27,56%,43%,56,43,13,1
2514,2009-05-26,55%,44%,55,44,11,1
2515,2009-05-25,56%,43%,56,43,13,1
2516,2009-05-24,57%,42%,57,42,15,1
2517,2009-05-23,57%,41%,57,41,16,2
2518,2009-05-22,57%,41%,57,41,16,2
2519,2009-05-21,56%,42%,56,42,14,2
2520,2009-05-20,58%,41%,58,41,17,1
2521,2009-05-19,58%,41%,58,41,17,1
2522,2009-05-18,57%,42%,57,42,15,1
2523,2009-05-17,56%,43%,56,43,13,1
2524,2009-05-16,55%,44%,55,44,11,1
2525,2009-05-15,57%,43%,57,43,14,0
2526,2009-05-14,57%,42%,57,42,15,1
2527,2009-05-13,57%,42%,57,42,15,1
2528,2009-05-12,56%,43%,56,43,13,1
2529,2009-05-10,58%,41%,58,41,17,1
2530,2009-05-09,58%,41%,58,41,17,1
2531,2009-05-08,58%,41%,58,41,17,1
2532,2009-05-07,57%,43%,57,43,14,0
2533,2009-05-06,57%,43%,57,43,14,0
2534,2009-05-05,56%,43%,56,43,13,1
2535,2009-05-04,57%,43%,57,43,14,0
2536,2009-05-03,56%,43%,56,43,13,1
2537,2009-05-02,54%,45%,54,45,9,1
2538,2009-05-01,54%,45%,54,45,9,1
2539,2009-04-30,54%,45%,54,45,9,1
2540,2009-04-29,55%,43%,55,43,12,2
2541,2009-04-28,56%,43%,56,43,13,1
2542,2009-04-27,55%,44%,55,44,11,1
2543,2009-04-26,54%,45%,54,45,9,1
2544,2009-04-25,56%,43%,56,43,13,1
2545,2009-04-24,55%,44%,55,44,11,1
2546,2009-04-23,55%,44%,55,44,11,1
2547,2009-04-22,54%,46%,54,46,8,0
2548,2009-04-21,54%,45%,54,45,9,1
2549,2009-04-20,55%,45%,55,45,10,0
2550,2009-04-19,55%,44%,55,44,11,1
2551,2009-04-18,55%,44%,55,44,11,1
2552,2009-04-17,55%,43%,55,43,12,2
2553,2009-04-16,55%,43%,55,43,12,2
2554,2009-04-15,55%,44%,55,44,11,1
2555,2009-04-14,55%,44%,55,44,11,1
2556,2009-04-13,55%,44%,55,44,11,1
2557,2009-04-12,55%,44%,55,44,11,1
2558,2009-04-11,55%,43%,55,43,12,2
2559,2009-04-10,55%,44%,55,44,11,1
2560,2009-04-09,55%,44%,55,44,11,1
2561,2009-04-08,57%,42%,57,42,15,1
2562,2009-04-07,58%,41%,58,41,17,1
2563,2009-04-06,58%,41%,58,41,17,1
2564,2009-04-05,56%,43%,56,43,13,1
2565,2009-04-04,56%,43%,56,43,13,1
2566,2009-04-03,56%,44%,56,44,12,0
2567,2009-04-02,56%,44%,56,44,12,0
2568,2009-04-01,57%,41%,57,41,16,2
2569,2009-03-31,59%,39%,59,39,20,2
2570,2009-03-30,58%,40%,58,40,18,2
2571,2009-03-29,58%,41%,58,41,17,1
2572,2009-03-28,56%,43%,56,43,13,1
2573,2009-03-27,56%,43%,56,43,13,1
2574,2009-03-26,56%,43%,56,43,13,1
2575,2009-03-25,56%,43%,56,43,13,1
2576,2009-03-24,56%,43%,56,43,13,1
2577,2009-03-23,56%,42%,56,42,14,2
2578,2009-03-22,56%,43%,56,43,13,1
2579,2009-03-21,55%,44%,55,44,11,1
2580,2009-03-20,55%,43%,55,43,12,2
2581,2009-03-19,56%,43%,56,43,13,1
2582,2009-03-18,57%,42%,57,42,15,1
2583,2009-03-17,56%,43%,56,43,13,1
2584,2009-03-16,56%,43%,56,43,13,1
2585,2009-03-15,56%,43%,56,43,13,1
2586,2009-03-14,57%,41%,57,41,16,2
2587,2009-03-13,57%,42%,57,42,15,1
2588,2009-03-12,58%,41%,58,41,17,1
2589,2009-03-11,56%,43%,56,43,13,1
2590,2009-03-10,56%,43%,56,43,13,1
2591,2009-03-09,56%,43%,56,43,13,1
2592,2009-03-08,56%,43%,56,43,13,1
2593,2009-03-07,56%,43%,56,43,13,1
2594,2009-03-06,58%,40%,58,40,18,2
2595,2009-03-05,59%,40%,59,40,19,1
2596,2009-03-04,60%,38%,60,38,22,2
2597,2009-03-03,60%,39%,60,39,21,1
2598,2009-03-02,58%,41%,58,41,17,1
2599,2009-03-01,58%,40%,58,40,18,2
2600,2009-02-28,59%,39%,59,39,20,2
2601,2009-02-27,60%,40%,60,40,20,0
2602,2009-02-26,60%,40%,60,40,20,0
2603,2009-02-25,59%,40%,59,40,19,1
2604,2009-02-24,60%,39%,60,39,21,1
2605,2009-02-23,58%,40%,58,40,18,2
2606,2009-02-22,58%,41%,58,41,17,1
2607,2009-02-21,57%,41%,57,41,16,2
2608,2009-02-20,59%,40%,59,40,19,1
2609,2009-02-19,60%,39%,60,39,21,1
2610,2009-02-18,61%,38%,61,38,23,1
2611,2009-02-17,61%,37%,61,37,24,2
2612,2009-02-16,60%,39%,60,39,21,1
2613,2009-02-15,60%,39%,60,39,21,1
2614,2009-02-14,60%,39%,60,39,21,1
2615,2009-02-13,60%,38%,60,38,22,2
2616,2009-02-12,61%,37%,61,37,24,2
2617,2009-02-11,60%,38%,60,38,22,2
2618,2009-02-10,60%,38%,60,38,22,2
2619,2009-02-09,60%,38%,60,38,22,2
2620,2009-02-08,59%,39%,59,39,20,2
2621,2009-02-07,60%,38%,60,38,22,2
2622,2009-02-06,61%,36%,61,36,25,3
2623,2009-02-05,62%,36%,62,36,26,2
2624,2009-02-04,62%,36%,62,36,26,2
2625,2009-02-03,61%,36%,61,36,25,3
2626,2009-02-02,60%,38%,60,38,22,2
2627,2009-02-01,63%,34%,63,34,29,3
2628,2009-01-31,63%,34%,63,34,29,3
2629,2009-01-30,63%,36%,63,36,27,1
2630,2009-01-29,62%,36%,62,36,26,2
2631,2009-01-28,62%,36%,62,36,26,2
2632,2009-01-27,62%,36%,62,36,26,2
2633,2009-01-26,60%,37%,60,37,23,3
2634,2009-01-25,60%,36%,60,36,24,4
2635,2009-01-24,61%,33%,61,33,28,6
2636,2009-01-23,62%,29%,62,29,33,9
2637,2009-01-22,64%,29%,64,29,35,7
2638,2009-01-21,65%,30%,65,30,35,5
2639,2009-01-20,67%,32%,67,32,35,1
2640,2009-01-19,67%,31%,67,31,36,2
2641,2009-01-18,65%,33%,65,33,32,2
2642,2009-01-17,66%,31%,66,31,35,3
2643,2009-01-16,65%,33%,65,33,32,2
2644,2009-01-15,65%,33%,65,33,32,2
2645,2009-01-14,66%,32%,66,32,34,2
2646,2009-01-13,67%,30%,67,30,37,3
2647,2009-01-12,67%,30%,67,30,37,3
2648,2009-01-11,67%,31%,67,31,36,2
2649,2009-01-10,69%,28%,69,28,41,3
2650,2009-01-09,69%,28%,69,28,41,3
2651,2009-01-08,69%,28%,69,28,41,3
2652,2009-01-07,69%,28%,69,28,41,3
2653,2009-01-06,69%,28%,69,28,41,3
2654,2009-01-05,69%,28%,69,28,41,3
2655,2009-01-04,69%,28%,69,28,41,3
2656,2008-12-22,68%,29%,68,29,39,3
2657,2008-12-21,69%,29%,69,29,40,2
2658,2008-12-20,69%,29%,69,29,40,2
2659,2008-12-19,69%,29%,69,29,40,2
2660,2008-12-18,68%,30%,68,30,38,2
2661,2008-12-17,66%,31%,66,31,35,3
2662,2008-12-16,65%,32%,65,32,33,3
2663,2008-12-15,65%,32%,65,32,33,3
2664,2008-12-14,67%,30%,67,30,37,3
2665,2008-12-13,67%,30%,67,30,37,3
2666,2008-12-12,67%,31%,67,31,36,2
2667,2008-12-11,66%,32%,66,32,34,2
2668,2008-12-10,67%,31%,67,31,36,2
2669,2008-12-09,67%,31%,67,31,36,2
2670,2008-12-08,68%,30%,68,30,38,2
2671,2008-12-07,67%,31%,67,31,36,2
2672,2008-12-06,67%,32%,67,32,35,1
2673,2008-12-05,66%,31%,66,31,35,3
2674,2008-12-04,67%,30%,67,30,37,3
2675,2008-12-03,67%,30%,67,30,37,3
2676,2008-12-02,65%,32%,65,32,33,3
2677,2008-12-01,64%,33%,64,33,31,3
2678,2008-11-30,63%,34%,63,34,29,3
2679,2008-11-26,62%,36%,62,36,26,2
2680,2008-11-25,60%,37%,60,37,23,3
2681,2008-11-24,59%,37%,59,37,22,4
2682,2008-11-23,61%,36%,61,36,25,3
2683,2008-11-22,61%,36%,61,36,25,3
2684,2008-11-21,62%,35%,62,35,27,3
2685,2008-11-20,61%,35%,61,35,26,4
2686,2008-11-19,61%,36%,61,36,25,3
2687,2008-11-18,59%,38%,59,38,21,3
2688,2008-11-17,61%,37%,61,37,24,2
2689,2008-11-16,59%,38%,59,38,21,3
2690,2008-11-15,59%,38%,59,38,21,3
2691,2008-11-14,58%,38%,58,38,20,4
2692,2008-11-13,57%,38%,57,38,19,5
2693,2008-11-12,58%,38%,58,38,20,4
2694,2008-11-11,58%,38%,58,38,20,4
2695,2008-11-10,58%,38%,58,38,20,4
2696,2008-11-09,56%,39%,56,39,17,5
2697,2008-11-08,54%,41%,54,41,13,5
2698,2008-11-07,53%,42%,53,42,11,5
2699,2008-11-06,52%,44%,52,44,8,4
