,Date,Total Approve,Total Disapprove,Total_Approve,Total_Disapprove,Relative_Approval,Neutral
0,1/19/2021,51%,48%,51,48,3,1
1,1/18/2021,48%,51%,48,51,-3,1
2,1/15/2021,48%,52%,48,52,-4,0
3,1/13/2021,46%,53%,46,53,-7,1
4,1/12/2021,49%,50%,49,50,-1,1
5,1/11/2021,48%,51%,48,51,-3,1
6,1/8/2021,48%,50%,48,50,-2,2
7,1/7/2021,49%,50%,49,50,-1,1
8,1/6/2021,47%,51%,47,51,-4,2
9,1/5/2021,47%,51%,47,51,-4,2
10,12/31/2020,45%,54%,45,54,-9,1
11,12/30/2020,47%,52%,47,52,-5,1
12,12/29/2020,47%,52%,47,52,-5,1
13,12/23/2020,45%,52%,45,52,-7,3
14,12/22/2020,45%,53%,45,53,-8,2
15,12/21/2020,46%,52%,46,52,-6,2
16,12/18/2020,48%,50%,48,50,-2,2
17,12/17/2020,51%,48%,51,48,3,1
18,12/16/2020,48%,51%,48,51,-3,1
19,12/15/2020,47%,52%,47,52,-5,1
20,12/14/2020,46%,52%,46,52,-6,2
21,12/11/2020,49%,49%,49,49,0,2
22,12/10/2020,49%,49%,49,49,0,2
23,12/9/2020,50%,49%,50,49,1,1
24,12/8/2020,49%,50%,49,50,-1,1
25,12/7/2020,48%,50%,48,50,-2,2
26,12/4/2020,49%,50%,49,50,-1,1
27,12/3/2020,50%,48%,50,48,2,2
28,12/2/2020,50%,48%,50,48,2,2
29,12/1/2020,49%,49%,49,49,0,2
30,11/30/2020,49%,49%,49,49,0,2
31,11/25/2020,49%,49%,49,49,0,2
32,11/24/2020,48%,50%,48,50,-2,2
33,11/23/2020,48%,50%,48,50,-2,2
34,11/20/2020,47%,51%,47,51,-4,2
35,11/19/2020,49%,50%,49,50,-1,1
36,11/18/2020,51%,48%,51,48,3,1
37,11/17/2020,52%,46%,52,46,6,2
38,11/16/2020,52%,47%,52,47,5,1
39,11/13/2020,52%,47%,52,47,5,1
40,11/12/2020,52%,47%,52,47,5,1
41,11/11/2020,53%,46%,53,46,7,1
42,11/10/2020,52%,47%,52,47,5,1
43,11/9/2020,52%,47%,52,47,5,1
44,11/6/2020,50%,48%,50,48,2,2
45,11/5/2020,48%,50%,48,50,-2,2
46,11/4/2020,49%,50%,49,50,-1,1
47,11/3/2020,49%,50%,49,50,-1,1
48,11/2/2020,52%,48%,52,48,4,0
49,10/30/2020,51%,48%,51,48,3,1
50,10/29/2020,52%,47%,52,47,5,1
51,10/28/2020,52%,47%,52,47,5,1
52,10/27/2020,51%,48%,51,48,3,1
53,10/26/2020,52%,46%,52,46,6,2
54,10/23/2020,51%,48%,51,48,3,1
55,10/22/2020,52%,48%,52,48,4,0
56,10/21/2020,49%,50%,49,50,-1,1
57,10/20/2020,49%,50%,49,50,-1,1
58,10/19/2020,48%,50%,48,50,-2,2
59,10/16/2020,48%,50%,48,50,-2,2
60,10/15/2020,47%,51%,47,51,-4,2
61,10/14/2020,47%,51%,47,51,-4,2
62,10/13/2020,48%,51%,48,51,-3,1
63,10/12/2020,49%,50%,49,50,-1,1
64,10/9/2020,46%,52%,46,52,-6,2
65,10/8/2020,45%,53%,45,53,-8,2
66,10/7/2020,44%,54%,44,54,-10,2
67,10/6/2020,45%,54%,45,54,-9,1
68,10/5/2020,46%,53%,46,53,-7,1
69,10/2/2020,46%,53%,46,53,-7,1
70,10/1/2020,49%,51%,49,51,-2,0
71,9/30/2020,46%,53%,46,53,-7,1
72,9/29/2020,47%,52%,47,52,-5,1
73,9/28/2020,46%,53%,46,53,-7,1
74,9/25/2020,52%,48%,52,48,4,0
75,9/24/2020,52%,48%,52,48,4,0
76,9/23/2020,50%,49%,50,49,1,1
77,9/22/2020,50%,49%,50,49,1,1
78,9/21/2020,51%,48%,51,48,3,1
79,9/18/2020,53%,46%,53,46,7,1
80,9/17/2020,51%,48%,51,48,3,1
81,9/16/2020,52%,46%,52,46,6,2
82,9/15/2020,51%,48%,51,48,3,1
83,9/14/2020,51%,48%,51,48,3,1
84,9/11/2020,48%,51%,48,51,-3,1
85,9/10/2020,48%,51%,48,51,-3,1
86,9/9/2020,48%,51%,48,51,-3,1
87,9/8/2020,50%,50%,50,50,0,0
88,9/7/2020,51%,49%,51,49,2,0
89,9/4/2020,52%,48%,52,48,4,0
90,9/3/2020,50%,49%,50,49,1,1
91,9/2/2020,49%,50%,49,50,-1,1
92,9/1/2020,47%,51%,47,51,-4,2
93,8/31/2020,47%,51%,47,51,-4,2
94,8/28/2020,46%,52%,46,52,-6,2
95,8/27/2020,47%,51%,47,51,-4,2
96,8/26/2020,47%,51%,47,51,-4,2
97,8/25/2020,49%,49%,49,49,0,2
98,8/24/2020,51%,47%,51,47,4,2
99,8/21/2020,51%,47%,51,47,4,2
100,8/20/2020,51%,48%,51,48,3,1
101,8/19/2020,47%,51%,47,51,-4,2
102,8/18/2020,48%,50%,48,50,-2,2
103,8/17/2020,47%,51%,47,51,-4,2
104,8/14/2020,47%,52%,47,52,-5,1
105,8/13/2020,47%,52%,47,52,-5,1
106,8/12/2020,48%,51%,48,51,-3,1
107,8/11/2020,49%,51%,49,51,-2,0
108,8/10/2020,48%,51%,48,51,-3,1
109,8/7/2020,48%,51%,48,51,-3,1
110,8/6/2020,46%,52%,46,52,-6,2
111,8/5/2020,48%,50%,48,50,-2,2
112,8/4/2020,49%,49%,49,49,0,2
113,8/3/2020,51%,47%,51,47,4,2
114,7/31/2020,50%,48%,50,48,2,2
115,7/30/2020,48%,51%,48,51,-3,1
116,7/29/2020,45%,54%,45,54,-9,1
117,7/28/2020,45%,54%,45,54,-9,1
118,7/27/2020,46%,52%,46,52,-6,2
119,7/24/2020,49%,49%,49,49,0,2
120,7/23/2020,49%,49%,49,49,0,2
121,7/22/2020,49%,50%,49,50,-1,1
122,7/21/2020,48%,51%,48,51,-3,1
123,7/20/2020,46%,53%,46,53,-7,1
124,7/17/2020,45%,53%,45,53,-8,2
125,7/16/2020,47%,51%,47,51,-4,2
126,7/15/2020,48%,50%,48,50,-2,2
127,7/14/2020,47%,51%,47,51,-4,2
128,7/13/2020,45%,54%,45,54,-9,1
129,7/10/2020,45%,53%,45,53,-8,2
130,7/9/2020,45%,54%,45,54,-9,1
131,7/8/2020,44%,54%,44,54,-10,2
132,7/7/2020,45%,53%,45,53,-8,2
133,7/6/2020,47%,52%,47,52,-5,1
134,7/3/2020,47%,52%,47,52,-5,1
135,7/2/2020,46%,52%,46,52,-6,2
136,7/1/2020,44%,54%,44,54,-10,2
137,6/30/2020,43%,55%,43,55,-12,2
138,6/29/2020,42%,55%,42,55,-13,3
139,6/26/2020,44%,53%,44,53,-9,3
140,6/25/2020,47%,51%,47,51,-4,2
141,6/24/2020,47%,52%,47,52,-5,1
142,6/23/2020,45%,53%,45,53,-8,2
143,6/22/2020,46%,52%,46,52,-6,2
144,6/19/2020,47%,51%,47,51,-4,2
145,6/18/2020,47%,51%,47,51,-4,2
146,6/17/2020,46%,53%,46,53,-7,1
147,6/16/2020,44%,55%,44,55,-11,1
148,6/15/2020,43%,56%,43,56,-13,1
149,6/12/2020,43%,55%,43,55,-12,2
150,6/11/2020,43%,56%,43,56,-13,1
151,6/10/2020,44%,55%,44,55,-11,1
152,6/9/2020,44%,55%,44,55,-11,1
153,6/8/2020,47%,52%,47,52,-5,1
154,6/5/2020,48%,51%,48,51,-3,1
155,6/4/2020,46%,52%,46,52,-6,2
156,6/3/2020,44%,54%,44,54,-10,2
157,6/2/2020,46%,53%,46,53,-7,1
158,6/1/2020,47%,52%,47,52,-5,1
159,5/29/2020,46%,53%,46,53,-7,1
160,5/28/2020,45%,54%,45,54,-9,1
161,5/27/2020,42%,57%,42,57,-15,1
162,5/26/2020,44%,55%,44,55,-11,1
163,5/25/2020,43%,55%,43,55,-12,2
164,5/22/2020,46%,53%,46,53,-7,1
165,5/21/2020,45%,54%,45,54,-9,1
166,5/20/2020,46%,53%,46,53,-7,1
167,5/19/2020,46%,53%,46,53,-7,1
168,5/18/2020,48%,51%,48,51,-3,1
169,5/15/2020,49%,50%,49,50,-1,1
170,5/14/2020,48%,51%,48,51,-3,1
171,5/13/2020,47%,51%,47,51,-4,2
172,5/12/2020,46%,52%,46,52,-6,2
173,5/11/2020,48%,50%,48,50,-2,2
174,5/8/2020,49%,49%,49,49,0,2
175,5/7/2020,49%,48%,49,48,1,3
176,5/6/2020,49%,49%,49,49,0,2
177,5/5/2020,47%,52%,47,52,-5,1
178,5/4/2020,46%,53%,46,53,-7,1
179,5/1/2020,45%,53%,45,53,-8,2
180,4/30/2020,46%,52%,46,52,-6,2
181,4/29/2020,46%,52%,46,52,-6,2
182,4/28/2020,44%,54%,44,54,-10,2
183,4/27/2020,44%,54%,44,54,-10,2
184,4/24/2020,45%,54%,45,54,-9,1
185,4/23/2020,44%,55%,44,55,-11,1
186,4/22/2020,44%,55%,44,55,-11,1
187,4/21/2020,44%,55%,44,55,-11,1
188,4/20/2020,46%,53%,46,53,-7,1
189,4/17/2020,46%,53%,46,53,-7,1
190,4/16/2020,46%,53%,46,53,-7,1
191,4/15/2020,45%,54%,45,54,-9,1
192,4/14/2020,44%,55%,44,55,-11,1
193,4/13/2020,43%,56%,43,56,-13,1
194,4/10/2020,43%,56%,43,56,-13,1
195,4/9/2020,46%,52%,46,52,-6,2
196,4/8/2020,47%,52%,47,52,-5,1
197,4/7/2020,47%,51%,47,51,-4,2
198,4/6/2020,44%,53%,44,53,-9,3
199,4/3/2020,44%,53%,44,53,-9,3
200,4/2/2020,48%,50%,48,50,-2,2
201,4/1/2020,48%,51%,48,51,-3,1
202,3/31/2020,47%,52%,47,52,-5,1
203,3/30/2020,45%,54%,45,54,-9,1
204,3/27/2020,46%,52%,46,52,-6,2
205,3/26/2020,46%,52%,46,52,-6,2
206,3/25/2020,46%,53%,46,53,-7,1
207,3/24/2020,46%,52%,46,52,-6,2
208,3/23/2020,45%,52%,45,52,-7,3
209,3/20/2020,46%,52%,46,52,-6,2
210,3/19/2020,47%,52%,47,52,-5,1
211,3/18/2020,46%,53%,46,53,-7,1
212,3/17/2020,46%,53%,46,53,-7,1
213,3/16/2020,47%,52%,47,52,-5,1
214,3/13/2020,49%,50%,49,50,-1,1
215,3/12/2020,48%,50%,48,50,-2,2
216,3/11/2020,47%,52%,47,52,-5,1
217,3/10/2020,48%,51%,48,51,-3,1
218,3/9/2020,48%,51%,48,51,-3,1
219,3/6/2020,47%,51%,47,51,-4,2
220,3/5/2020,48%,50%,48,50,-2,2
221,3/4/2020,48%,49%,48,49,-1,3
222,3/3/2020,47%,51%,47,51,-4,2
223,3/2/2020,46%,52%,46,52,-6,2
224,2/28/2020,47%,52%,47,52,-5,1
225,2/27/2020,52%,47%,52,47,5,1
226,2/26/2020,51%,48%,51,48,3,1
227,2/25/2020,52%,47%,52,47,5,1
228,2/24/2020,49%,50%,49,50,-1,1
229,2/21/2020,49%,51%,49,51,-2,0
230,2/20/2020,49%,50%,49,50,-1,1
231,2/19/2020,50%,49%,50,49,1,1
232,2/18/2020,50%,49%,50,49,1,1
233,2/17/2020,49%,50%,49,50,-1,1
234,2/14/2020,49%,49%,49,49,0,2
235,2/13/2020,50%,49%,50,49,1,1
236,2/12/2020,50%,48%,50,48,2,2
237,2/11/2020,49%,49%,49,49,0,2
238,2/10/2020,50%,48%,50,48,2,2
239,2/7/2020,49%,49%,49,49,0,2
240,2/6/2020,50%,49%,50,49,1,1
241,2/5/2020,48%,50%,48,50,-2,2
242,2/4/2020,48%,51%,48,51,-3,1
243,2/3/2020,48%,50%,48,50,-2,2
244,1/31/2020,50%,49%,50,49,1,1
245,1/30/2020,50%,49%,50,49,1,1
246,1/29/2020,49%,51%,49,51,-2,0
247,1/28/2020,49%,50%,49,50,-1,1
248,1/27/2020,50%,49%,50,49,1,1
249,1/24/2020,49%,49%,49,49,0,2
250,1/23/2020,48%,50%,48,50,-2,2
251,1/22/2020,46%,53%,46,53,-7,1
252,1/21/2020,47%,53%,47,53,-6,0
253,1/20/2020,48%,51%,48,51,-3,1
254,1/17/2020,49%,50%,49,50,-1,1
255,1/16/2020,51%,47%,51,47,4,2
256,1/15/2020,49%,50%,49,50,-1,1
257,1/14/2020,49%,50%,49,50,-1,1
258,1/13/2020,48%,50%,48,50,-2,2
259,1/10/2020,48%,51%,48,51,-3,1
260,1/9/2020,48%,51%,48,51,-3,1
261,1/8/2020,46%,53%,46,53,-7,1
262,1/7/2020,48%,50%,48,50,-2,2
263,1/6/2020,49%,50%,49,50,-1,1
264,1/3/2020,50%,50%,50,50,0,0
265,12/31/2019,48%,51%,48,51,-3,1
266,12/30/2019,46%,53%,46,53,-7,1
267,12/27/2019,46%,53%,46,53,-7,1
268,12/24/2019,48%,51%,48,51,-3,1
269,12/23/2019,48%,51%,48,51,-3,1
270,12/20/2019,50%,48%,50,48,2,2
271,12/19/2019,49%,49%,49,49,0,2
272,12/18/2019,49%,49%,49,49,0,2
273,12/17/2019,48%,49%,48,49,-1,3
274,12/16/2019,47%,51%,47,51,-4,2
275,12/13/2019,49%,49%,49,49,0,2
276,12/12/2019,49%,50%,49,50,-1,1
277,12/11/2019,51%,48%,51,48,3,1
278,12/10/2019,50%,49%,50,49,1,1
279,12/9/2019,51%,48%,51,48,3,1
280,12/6/2019,51%,48%,51,48,3,1
281,12/5/2019,52%,47%,52,47,5,1
282,12/4/2019,49%,50%,49,50,-1,1
283,12/3/2019,48%,50%,48,50,-2,2
284,12/2/2019,46%,53%,46,53,-7,1
285,11/26/2019,46%,53%,46,53,-7,1
286,11/25/2019,44%,55%,44,55,-11,1
287,11/22/2019,46%,52%,46,52,-6,2
288,11/21/2019,46%,53%,46,53,-7,1
289,11/20/2019,48%,51%,48,51,-3,1
290,11/19/2019,48%,51%,48,51,-3,1
291,11/18/2019,50%,49%,50,49,1,1
292,11/15/2019,50%,49%,50,49,1,1
293,11/14/2019,48%,51%,48,51,-3,1
294,11/13/2019,46%,53%,46,53,-7,1
295,11/12/2019,44%,54%,44,54,-10,2
296,11/11/2019,47%,52%,47,52,-5,1
297,11/8/2019,49%,50%,49,50,-1,1
298,11/7/2019,50%,49%,50,49,1,1
299,11/6/2019,46%,52%,46,52,-6,2
300,11/5/2019,46%,54%,46,54,-8,0
301,11/4/2019,44%,55%,44,55,-11,1
302,11/1/2019,45%,54%,45,54,-9,1
303,10/31/2019,45%,54%,45,54,-9,1
304,10/30/2019,47%,52%,47,52,-5,1
305,10/29/2019,46%,53%,46,53,-7,1
306,10/28/2019,45%,54%,45,54,-9,1
307,10/25/2019,43%,56%,43,56,-13,1
308,10/24/2019,43%,54%,43,54,-11,3
309,10/23/2019,44%,53%,44,53,-9,3
310,10/22/2019,45%,52%,45,52,-7,3
311,10/21/2019,45%,53%,45,53,-8,2
312,10/18/2019,47%,52%,47,52,-5,1
313,10/17/2019,48%,51%,48,51,-3,1
314,10/16/2019,50%,49%,50,49,1,1
315,10/15/2019,49%,50%,49,50,-1,1
316,10/14/2019,49%,50%,49,50,-1,1
317,10/11/2019,49%,50%,49,50,-1,1
318,10/10/2019,47%,51%,47,51,-4,2
319,10/9/2019,46%,52%,46,52,-6,2
320,10/8/2019,45%,52%,45,52,-7,3
321,10/7/2019,47%,51%,47,51,-4,2
322,10/4/2019,48%,50%,48,50,-2,2
323,10/3/2019,47%,52%,47,52,-5,1
324,10/2/2019,48%,51%,48,51,-3,1
325,10/1/2019,48%,50%,48,50,-2,2
326,9/30/2019,49%,50%,49,50,-1,1
327,9/27/2019,48%,50%,48,50,-2,2
328,9/26/2019,49%,49%,49,49,0,2
329,9/25/2019,51%,47%,51,47,4,2
330,9/24/2019,53%,45%,53,45,8,2
331,9/23/2019,52%,46%,52,46,6,2
332,9/20/2019,52%,47%,52,47,5,1
333,9/19/2019,49%,50%,49,50,-1,1
334,9/18/2019,51%,48%,51,48,3,1
335,9/17/2019,49%,50%,49,50,-1,1
336,9/16/2019,50%,49%,50,49,1,1
337,9/13/2019,47%,52%,47,52,-5,1
338,9/12/2019,48%,51%,48,51,-3,1
339,9/11/2019,47%,53%,47,53,-6,0
340,9/10/2019,47%,53%,47,53,-6,0
341,9/9/2019,46%,53%,46,53,-7,1
342,9/6/2019,46%,52%,46,52,-6,2
343,9/5/2019,46%,52%,46,52,-6,2
344,9/4/2019,46%,52%,46,52,-6,2
345,9/3/2019,46%,53%,46,53,-7,1
346,9/2/2019,45%,54%,45,54,-9,1
347,8/30/2019,47%,51%,47,51,-4,2
348,8/29/2019,47%,51%,47,51,-4,2
349,8/28/2019,47%,52%,47,52,-5,1
350,8/27/2019,47%,51%,47,51,-4,2
351,8/26/2019,48%,50%,48,50,-2,2
352,8/23/2019,50%,48%,50,48,2,2
353,8/22/2019,48%,50%,48,50,-2,2
354,8/21/2019,46%,52%,46,52,-6,2
355,8/20/2019,44%,54%,44,54,-10,2
356,8/19/2019,46%,53%,46,53,-7,1
357,8/16/2019,46%,52%,46,52,-6,2
358,8/15/2019,46%,53%,46,53,-7,1
359,8/14/2019,45%,54%,45,54,-9,1
360,8/13/2019,46%,53%,46,53,-7,1
361,8/12/2019,47%,52%,47,52,-5,1
362,8/9/2019,47%,52%,47,52,-5,1
363,8/8/2019,47%,51%,47,51,-4,2
364,8/7/2019,47%,51%,47,51,-4,2
365,8/6/2019,49%,49%,49,49,0,2
366,8/5/2019,48%,50%,48,50,-2,2
367,8/2/2019,48%,50%,48,50,-2,2
368,8/1/2019,48%,51%,48,51,-3,1
369,7/31/2019,47%,52%,47,52,-5,1
370,7/30/2019,47%,51%,47,51,-4,2
371,7/29/2019,47%,52%,47,52,-5,1
372,7/26/2019,47%,51%,47,51,-4,2
373,7/25/2019,48%,51%,48,51,-3,1
374,7/24/2019,48%,50%,48,50,-2,2
375,7/23/2019,50%,49%,50,49,1,1
376,7/22/2019,49%,49%,49,49,0,2
377,7/19/2019,50%,48%,50,48,2,2
378,7/18/2019,49%,49%,49,49,0,2
379,7/17/2019,50%,48%,50,48,2,2
380,7/16/2019,48%,50%,48,50,-2,2
381,7/15/2019,46%,52%,46,52,-6,2
382,7/12/2019,46%,52%,46,52,-6,2
383,7/11/2019,48%,51%,48,51,-3,1
384,7/10/2019,49%,50%,49,50,-1,1
385,7/9/2019,49%,51%,49,51,-2,0
386,7/8/2019,50%,49%,50,49,1,1
387,7/3/2019,49%,50%,49,50,-1,1
388,7/2/2019,48%,51%,48,51,-3,1
389,7/1/2019,47%,51%,47,51,-4,2
390,6/28/2019,49%,50%,49,50,-1,1
391,6/27/2019,50%,48%,50,48,2,2
392,6/26/2019,48%,50%,48,50,-2,2
393,6/25/2019,47%,51%,47,51,-4,2
394,6/24/2019,48%,50%,48,50,-2,2
395,6/21/2019,49%,49%,49,49,0,2
396,6/20/2019,50%,48%,50,48,2,2
397,6/19/2019,47%,50%,47,50,-3,3
398,6/18/2019,48%,51%,48,51,-3,1
399,6/17/2019,48%,50%,48,50,-2,2
400,6/14/2019,51%,47%,51,47,4,2
401,6/13/2019,50%,47%,50,47,3,3
402,6/12/2019,51%,47%,51,47,4,2
403,6/11/2019,49%,49%,49,49,0,2
404,6/10/2019,50%,48%,50,48,2,2
405,6/7/2019,48%,50%,48,50,-2,2
406,6/6/2019,50%,49%,50,49,1,1
407,6/5/2019,49%,50%,49,50,-1,1
408,6/4/2019,49%,50%,49,50,-1,1
409,6/3/2019,47%,52%,47,52,-5,1
410,5/31/2019,48%,51%,48,51,-3,1
411,5/30/2019,48%,52%,48,52,-4,0
412,5/29/2019,47%,52%,47,52,-5,1
413,5/28/2019,46%,53%,46,53,-7,1
414,5/27/2019,46%,53%,46,53,-7,1
415,5/24/2019,46%,52%,46,52,-6,2
416,5/23/2019,47%,52%,47,52,-5,1
417,5/22/2019,46%,53%,46,53,-7,1
418,5/21/2019,46%,53%,46,53,-7,1
419,5/20/2019,44%,54%,44,54,-10,2
420,5/17/2019,45%,53%,45,53,-8,2
421,5/16/2019,45%,53%,45,53,-8,2
422,5/15/2019,48%,50%,48,50,-2,2
423,5/14/2019,49%,49%,49,49,0,2
424,5/13/2019,50%,49%,50,49,1,1
425,5/10/2019,49%,50%,49,50,-1,1
426,5/9/2019,49%,50%,49,50,-1,1
427,5/8/2019,49%,49%,49,49,0,2
428,5/7/2019,49%,49%,49,49,0,2
429,5/6/2019,50%,48%,50,48,2,2
430,5/3/2019,50%,47%,50,47,3,3
431,5/2/2019,51%,47%,51,47,4,2
432,5/1/2019,50%,48%,50,48,2,2
433,4/30/2019,49%,49%,49,49,0,2
434,4/29/2019,48%,49%,48,49,-1,3
435,4/26/2019,49%,49%,49,49,0,2
436,4/25/2019,50%,48%,50,48,2,2
437,4/24/2019,49%,49%,49,49,0,2
438,4/23/2019,49%,49%,49,49,0,2
439,4/22/2019,47%,51%,47,51,-4,2
440,4/19/2019,49%,51%,49,51,-2,0
441,4/18/2019,50%,50%,50,50,0,0
442,4/17/2019,52%,48%,52,48,4,0
443,4/16/2019,52%,48%,52,48,4,0
444,4/15/2019,50%,49%,50,49,1,1
445,4/12/2019,49%,50%,49,50,-1,1
446,4/11/2019,50%,49%,50,49,1,1
447,4/10/2019,51%,47%,51,47,4,2
448,4/9/2019,53%,45%,53,45,8,2
449,4/8/2019,51%,47%,51,47,4,2
450,4/5/2019,51%,47%,51,47,4,2
451,4/4/2019,49%,49%,49,49,0,2
452,4/3/2019,50%,48%,50,48,2,2
453,4/2/2019,48%,51%,48,51,-3,1
454,4/1/2019,51%,49%,51,49,2,0
455,3/29/2019,49%,50%,49,50,-1,1
456,3/28/2019,50%,49%,50,49,1,1
457,3/27/2019,49%,50%,49,50,-1,1
458,3/26/2019,47%,52%,47,52,-5,1
459,3/25/2019,45%,54%,45,54,-9,1
460,3/22/2019,45%,53%,45,53,-8,2
461,3/21/2019,49%,49%,49,49,0,2
462,3/20/2019,48%,50%,48,50,-2,2
463,3/19/2019,47%,52%,47,52,-5,1
464,3/18/2019,47%,51%,47,51,-4,2
465,3/15/2019,48%,51%,48,51,-3,1
466,3/14/2019,49%,50%,49,50,-1,1
467,3/13/2019,47%,52%,47,52,-5,1
468,3/12/2019,47%,51%,47,51,-4,2
469,3/11/2019,49%,50%,49,50,-1,1
470,3/8/2019,50%,49%,50,49,1,1
471,3/7/2019,50%,49%,50,49,1,1
472,3/6/2019,48%,51%,48,51,-3,1
473,3/5/2019,48%,51%,48,51,-3,1
474,3/4/2019,47%,51%,47,51,-4,2
475,3/1/2019,49%,49%,49,49,0,2
476,2/28/2019,49%,50%,49,50,-1,1
477,2/27/2019,49%,49%,49,49,0,2
478,2/26/2019,49%,50%,49,50,-1,1
479,2/25/2019,49%,49%,49,49,0,2
480,2/22/2019,49%,49%,49,49,0,2
481,2/21/2019,49%,50%,49,50,-1,1
482,2/20/2019,49%,51%,49,51,-2,0
483,2/19/2019,49%,50%,49,50,-1,1
484,2/18/2019,50%,49%,50,49,1,1
485,2/15/2019,50%,49%,50,49,1,1
486,2/14/2019,50%,49%,50,49,1,1
487,2/13/2019,50%,49%,50,49,1,1
488,2/12/2019,50%,48%,50,48,2,2
489,2/11/2019,52%,47%,52,47,5,1
490,2/8/2019,50%,49%,50,49,1,1
491,2/7/2019,49%,50%,49,50,-1,1
492,2/6/2019,48%,51%,48,51,-3,1
493,2/5/2019,48%,51%,48,51,-3,1
494,2/4/2019,45%,54%,45,54,-9,1
495,2/1/2019,43%,57%,43,57,-14,0
496,1/31/2019,43%,56%,43,56,-13,1
497,1/30/2019,43%,56%,43,56,-13,1
498,1/29/2019,45%,54%,45,54,-9,1
499,1/28/2019,45%,54%,45,54,-9,1
500,1/25/2019,45%,54%,45,54,-9,1
501,1/24/2019,44%,55%,44,55,-11,1
502,1/23/2019,44%,56%,44,56,-12,0
503,1/22/2019,44%,56%,44,56,-12,0
504,1/21/2019,44%,56%,44,56,-12,0
505,1/18/2019,44%,55%,44,55,-11,1
506,1/17/2019,44%,55%,44,55,-11,1
507,1/16/2019,43%,55%,43,55,-12,2
508,1/15/2019,43%,55%,43,55,-12,2
509,1/14/2019,43%,55%,43,55,-12,2
510,1/11/2019,45%,54%,45,54,-9,1
511,1/10/2019,45%,53%,45,53,-8,2
512,1/9/2019,47%,52%,47,52,-5,1
513,1/8/2019,46%,53%,46,53,-7,1
514,1/7/2019,46%,53%,46,53,-7,1
515,1/4/2019,46%,53%,46,53,-7,1
516,1/3/2019,47%,51%,47,51,-4,2
517,12/28/2018,47%,52%,47,52,-5,1
518,12/27/2018,47%,52%,47,52,-5,1
519,12/24/2018,46%,52%,46,52,-6,2
520,12/21/2018,49%,50%,49,50,-1,1
521,12/20/2018,48%,51%,48,51,-3,1
522,12/19/2018,47%,52%,47,52,-5,1
523,12/18/2018,46%,53%,46,53,-7,1
524,12/17/2018,47%,51%,47,51,-4,2
525,12/14/2018,48%,50%,48,50,-2,2
526,12/13/2018,49%,48%,49,48,1,3
527,12/12/2018,48%,50%,48,50,-2,2
528,12/11/2018,49%,49%,49,49,0,2
529,12/10/2018,48%,51%,48,51,-3,1
530,12/7/2018,50%,49%,50,49,1,1
531,12/6/2018,49%,50%,49,50,-1,1
532,12/5/2018,50%,48%,50,48,2,2
533,12/4/2018,48%,51%,48,51,-3,1
534,12/3/2018,48%,50%,48,50,-2,2
535,11/30/2018,47%,51%,47,51,-4,2
536,11/29/2018,47%,51%,47,51,-4,2
537,11/28/2018,48%,50%,48,50,-2,2
538,11/27/2018,49%,49%,49,49,0,2
539,11/21/2018,51%,48%,51,48,3,1
540,11/20/2018,50%,49%,50,49,1,1
541,11/19/2018,50%,49%,50,49,1,1
542,11/16/2018,49%,50%,49,50,-1,1
543,11/15/2018,48%,50%,48,50,-2,2
544,11/14/2018,46%,52%,46,52,-6,2
545,11/13/2018,46%,52%,46,52,-6,2
546,11/12/2018,46%,52%,46,52,-6,2
547,11/9/2018,48%,50%,48,50,-2,2
548,11/8/2018,48%,50%,48,50,-2,2
549,11/7/2018,48%,50%,48,50,-2,2
550,11/6/2018,48%,50%,48,50,-2,2
551,11/5/2018,50%,49%,50,49,1,1
552,11/2/2018,51%,47%,51,47,4,2
553,11/1/2018,49%,50%,49,50,-1,1
554,10/31/2018,49%,50%,49,50,-1,1
555,10/30/2018,48%,51%,48,51,-3,1
556,10/29/2018,50%,49%,50,49,1,1
557,10/26/2018,48%,51%,48,51,-3,1
558,10/25/2018,47%,51%,47,51,-4,2
559,10/24/2018,46%,52%,46,52,-6,2
560,10/23/2018,48%,51%,48,51,-3,1
561,10/22/2018,47%,52%,47,52,-5,1
562,10/19/2018,47%,52%,47,52,-5,1
563,10/18/2018,47%,52%,47,52,-5,1
564,10/17/2018,49%,50%,49,50,-1,1
565,10/16/2018,51%,48%,51,48,3,1
566,10/15/2018,51%,49%,51,49,2,0
567,10/12/2018,49%,50%,49,50,-1,1
568,10/11/2018,49%,50%,49,50,-1,1
569,10/10/2018,49%,49%,49,49,0,2
570,10/9/2018,51%,47%,51,47,4,2
571,10/8/2018,51%,47%,51,47,4,2
572,10/5/2018,51%,48%,51,48,3,1
573,10/4/2018,50%,49%,50,49,1,1
574,10/3/2018,49%,50%,49,50,-1,1
575,10/2/2018,48%,50%,48,50,-2,2
576,10/1/2018,48%,50%,48,50,-2,2
577,9/28/2018,47%,51%,47,51,-4,2
578,9/27/2018,47%,52%,47,52,-5,1
579,9/26/2018,47%,51%,47,51,-4,2
580,9/25/2018,47%,50%,47,50,-3,3
581,9/24/2018,49%,50%,49,50,-1,1
582,9/21/2018,49%,50%,49,50,-1,1
583,9/20/2018,48%,50%,48,50,-2,2
584,9/19/2018,47%,52%,47,52,-5,1
585,9/18/2018,48%,51%,48,51,-3,1
586,9/17/2018,49%,50%,49,50,-1,1
587,9/14/2018,47%,51%,47,51,-4,2
588,9/13/2018,46%,52%,46,52,-6,2
589,9/12/2018,45%,53%,45,53,-8,2
590,9/11/2018,47%,51%,47,51,-4,2
591,9/10/2018,48%,51%,48,51,-3,1
592,9/7/2018,48%,52%,48,52,-4,0
593,9/6/2018,46%,53%,46,53,-7,1
594,9/5/2018,44%,54%,44,54,-10,2
595,9/4/2018,45%,53%,45,53,-8,2
596,9/3/2018,47%,51%,47,51,-4,2
597,8/31/2018,48%,50%,48,50,-2,2
598,8/30/2018,48%,51%,48,51,-3,1
599,8/29/2018,47%,53%,47,53,-6,0
600,8/28/2018,46%,53%,46,53,-7,1
601,8/27/2018,46%,54%,46,54,-8,0
602,8/24/2018,46%,53%,46,53,-7,1
603,8/23/2018,46%,52%,46,52,-6,2
604,8/22/2018,46%,52%,46,52,-6,2
605,8/21/2018,46%,53%,46,53,-7,1
606,8/20/2018,48%,52%,48,52,-4,0
607,8/17/2018,48%,51%,48,51,-3,1
608,8/16/2018,49%,50%,49,50,-1,1
609,8/15/2018,49%,49%,49,49,0,2
610,8/14/2018,50%,49%,50,49,1,1
611,8/13/2018,48%,50%,48,50,-2,2
612,8/10/2018,46%,52%,46,52,-6,2
613,8/9/2018,47%,51%,47,51,-4,2
614,8/8/2018,47%,51%,47,51,-4,2
615,8/7/2018,47%,51%,47,51,-4,2
616,8/6/2018,47%,51%,47,51,-4,2
617,8/3/2018,48%,50%,48,50,-2,2
618,8/2/2018,50%,49%,50,49,1,1
619,8/1/2018,48%,50%,48,50,-2,2
620,7/31/2018,48%,50%,48,50,-2,2
621,7/30/2018,47%,51%,47,51,-4,2
622,7/27/2018,46%,52%,46,52,-6,2
623,7/26/2018,46%,53%,46,53,-7,1
624,7/25/2018,46%,52%,46,52,-6,2
625,7/24/2018,46%,53%,46,53,-7,1
626,7/23/2018,46%,53%,46,53,-7,1
627,7/20/2018,44%,55%,44,55,-11,1
628,7/19/2018,45%,54%,45,54,-9,1
629,7/18/2018,44%,54%,44,54,-10,2
630,7/17/2018,46%,53%,46,53,-7,1
631,7/16/2018,45%,54%,45,54,-9,1
632,7/13/2018,46%,53%,46,53,-7,1
633,7/12/2018,46%,52%,46,52,-6,2
634,7/11/2018,47%,51%,47,51,-4,2
635,7/10/2018,47%,51%,47,51,-4,2
636,7/9/2018,47%,52%,47,52,-5,1
637,7/6/2018,47%,52%,47,52,-5,1
638,7/3/2018,48%,51%,48,51,-3,1
639,7/2/2018,48%,51%,48,51,-3,1
640,6/29/2018,47%,52%,47,52,-5,1
641,6/28/2018,46%,53%,46,53,-7,1
642,6/27/2018,45%,54%,45,54,-9,1
643,6/26/2018,46%,52%,46,52,-6,2
644,6/25/2018,46%,52%,46,52,-6,2
645,6/22/2018,46%,52%,46,52,-6,2
646,6/21/2018,46%,52%,46,52,-6,2
647,6/20/2018,48%,50%,48,50,-2,2
648,6/19/2018,48%,50%,48,50,-2,2
649,6/18/2018,48%,50%,48,50,-2,2
650,6/15/2018,47%,51%,47,51,-4,2
651,6/14/2018,49%,49%,49,49,0,2
652,6/13/2018,49%,49%,49,49,0,2
653,6/12/2018,49%,50%,49,50,-1,1
654,6/11/2018,47%,52%,47,52,-5,1
655,6/8/2018,47%,51%,47,51,-4,2
656,6/7/2018,49%,49%,49,49,0,2
657,6/6/2018,49%,49%,49,49,0,2
658,6/5/2018,48%,50%,48,50,-2,2
659,6/4/2018,48%,50%,48,50,-2,2
660,6/1/2018,48%,50%,48,50,-2,2
661,5/31/2018,47%,52%,47,52,-5,1
662,5/30/2018,47%,52%,47,52,-5,1
663,5/29/2018,48%,51%,48,51,-3,1
664,5/28/2018,49%,50%,49,50,-1,1
665,5/25/2018,49%,50%,49,50,-1,1
666,5/24/2018,49%,50%,49,50,-1,1
667,5/23/2018,48%,51%,48,51,-3,1
668,5/22/2018,50%,49%,50,49,1,1
669,5/21/2018,47%,51%,47,51,-4,2
670,5/18/2018,50%,49%,50,49,1,1
671,5/17/2018,49%,50%,49,50,-1,1
672,5/16/2018,48%,50%,48,50,-2,2
673,5/15/2018,47%,52%,47,52,-5,1
674,5/14/2018,47%,52%,47,52,-5,1
675,5/11/2018,49%,49%,49,49,0,2
676,5/10/2018,48%,50%,48,50,-2,2
677,5/9/2018,47%,51%,47,51,-4,2
678,5/8/2018,47%,51%,47,51,-4,2
679,5/7/2018,49%,49%,49,49,0,2
680,5/4/2018,51%,49%,51,49,2,0
681,5/3/2018,50%,49%,50,49,1,1
682,5/2/2018,49%,49%,49,49,0,2
683,5/1/2018,48%,50%,48,50,-2,2
684,4/30/2018,47%,52%,47,52,-5,1
685,4/27/2018,47%,52%,47,52,-5,1
686,4/26/2018,47%,52%,47,52,-5,1
687,4/25/2018,48%,50%,48,50,-2,2
688,4/24/2018,48%,50%,48,50,-2,2
689,4/23/2018,48%,50%,48,50,-2,2
690,4/20/2018,49%,50%,49,50,-1,1
691,4/19/2018,48%,51%,48,51,-3,1
692,4/18/2018,50%,49%,50,49,1,1
693,4/17/2018,49%,50%,49,50,-1,1
694,4/16/2018,51%,48%,51,48,3,1
695,4/13/2018,50%,49%,50,49,1,1
696,4/12/2018,50%,49%,50,49,1,1
697,4/11/2018,49%,50%,49,50,-1,1
698,4/10/2018,48%,51%,48,51,-3,1
699,4/9/2018,48%,52%,48,52,-4,0
700,4/6/2018,47%,52%,47,52,-5,1
701,4/5/2018,47%,51%,47,51,-4,2
702,4/4/2018,51%,48%,51,48,3,1
703,4/3/2018,49%,50%,49,50,-1,1
704,4/2/2018,50%,49%,50,49,1,1
705,3/30/2018,47%,52%,47,52,-5,1
706,3/29/2018,45%,53%,45,53,-8,2
707,3/28/2018,45%,53%,45,53,-8,2
708,3/27/2018,46%,53%,46,53,-7,1
709,3/26/2018,46%,52%,46,52,-6,2
710,3/23/2018,46%,52%,46,52,-6,2
711,3/22/2018,47%,52%,47,52,-5,1
712,3/21/2018,46%,52%,46,52,-6,2
713,3/20/2018,47%,52%,47,52,-5,1
714,3/19/2018,47%,52%,47,52,-5,1
715,3/16/2018,47%,52%,47,52,-5,1
716,3/15/2018,46%,53%,46,53,-7,1
717,3/14/2018,47%,52%,47,52,-5,1
718,3/13/2018,48%,51%,48,51,-3,1
719,3/12/2018,45%,53%,45,53,-8,2
720,3/9/2018,44%,54%,44,54,-10,2
721,3/8/2018,45%,54%,45,54,-9,1
722,3/7/2018,46%,53%,46,53,-7,1
723,3/6/2018,48%,52%,48,52,-4,0
724,3/5/2018,48%,52%,48,52,-4,0
725,3/2/2018,49%,50%,49,50,-1,1
726,3/1/2018,49%,50%,49,50,-1,1
727,2/28/2018,49%,50%,49,50,-1,1
728,2/27/2018,50%,48%,50,48,2,2
729,2/26/2018,49%,49%,49,49,0,2
730,2/23/2018,50%,49%,50,49,1,1
731,2/22/2018,48%,51%,48,51,-3,1
732,2/21/2018,48%,51%,48,51,-3,1
733,2/20/2018,46%,53%,46,53,-7,1
734,2/19/2018,47%,52%,47,52,-5,1
735,2/16/2018,47%,52%,47,52,-5,1
736,2/15/2018,48%,51%,48,51,-3,1
737,2/14/2018,47%,52%,47,52,-5,1
738,2/13/2018,48%,50%,48,50,-2,2
739,2/12/2018,48%,50%,48,50,-2,2
740,2/9/2018,49%,50%,49,50,-1,1
741,2/8/2018,48%,50%,48,50,-2,2
742,2/7/2018,48%,51%,48,51,-3,1
743,2/6/2018,49%,50%,49,50,-1,1
744,2/5/2018,49%,49%,49,49,0,2
745,2/2/2018,49%,49%,49,49,0,2
746,2/1/2018,45%,53%,45,53,-8,2
747,1/31/2018,44%,54%,44,54,-10,2
748,1/30/2018,43%,56%,43,56,-13,1
749,1/29/2018,43%,56%,43,56,-13,1
750,1/26/2018,44%,55%,44,55,-11,1
751,1/25/2018,45%,54%,45,54,-9,1
752,1/24/2018,44%,55%,44,55,-11,1
753,1/23/2018,43%,57%,43,57,-14,0
754,1/22/2018,42%,56%,42,56,-14,2
755,1/19/2018,45%,54%,45,54,-9,1
756,1/18/2018,45%,54%,45,54,-9,1
757,1/17/2018,45%,54%,45,54,-9,1
758,1/16/2018,45%,54%,45,54,-9,1
759,1/15/2018,46%,52%,46,52,-6,2
760,1/12/2018,46%,53%,46,53,-7,1
761,1/11/2018,45%,53%,45,53,-8,2
762,1/10/2018,44%,55%,44,55,-11,1
763,1/9/2018,43%,56%,43,56,-13,1
764,1/8/2018,42%,56%,42,56,-14,2
765,1/5/2018,44%,54%,44,54,-10,2
766,1/4/2018,45%,53%,45,53,-8,2
767,1/3/2018,44%,54%,44,54,-10,2
768,12/29/2017,45%,53%,45,53,-8,2
769,12/28/2017,46%,53%,46,53,-7,1
770,12/27/2017,45%,53%,45,53,-8,2
771,12/22/2017,44%,54%,44,54,-10,2
772,12/21/2017,43%,55%,43,55,-12,2
773,12/20/2017,44%,54%,44,54,-10,2
774,12/19/2017,43%,55%,43,55,-12,2
775,12/18/2017,42%,55%,42,55,-13,3
776,12/15/2017,40%,57%,40,57,-17,3
777,12/14/2017,41%,57%,41,57,-16,2
778,12/13/2017,41%,57%,41,57,-16,2
779,12/12/2017,41%,57%,41,57,-16,2
780,12/11/2017,42%,56%,42,56,-14,2
781,12/8/2017,42%,56%,42,56,-14,2
782,12/7/2017,44%,55%,44,55,-11,1
783,12/6/2017,42%,56%,42,56,-14,2
784,12/5/2017,43%,55%,43,55,-12,2
785,12/4/2017,42%,56%,42,56,-14,2
786,12/1/2017,44%,55%,44,55,-11,1
787,11/30/2017,42%,56%,42,56,-14,2
788,11/29/2017,41%,57%,41,57,-16,2
789,11/28/2017,42%,56%,42,56,-14,2
790,11/27/2017,43%,55%,43,55,-12,2
791,11/22/2017,44%,54%,44,54,-10,2
792,11/21/2017,43%,56%,43,56,-13,1
793,11/20/2017,41%,57%,41,57,-16,2
794,11/17/2017,42%,56%,42,56,-14,2
795,11/16/2017,41%,57%,41,57,-16,2
796,11/15/2017,45%,53%,45,53,-8,2
797,11/14/2017,44%,54%,44,54,-10,2
798,11/13/2017,46%,53%,46,53,-7,1
799,11/10/2017,44%,55%,44,55,-11,1
800,11/9/2017,43%,56%,43,56,-13,1
801,11/8/2017,42%,57%,42,57,-15,1
802,11/7/2017,43%,56%,43,56,-13,1
803,11/6/2017,44%,55%,44,55,-11,1
804,11/3/2017,43%,55%,43,55,-12,2
805,11/2/2017,43%,56%,43,56,-13,1
806,11/1/2017,43%,55%,43,55,-12,2
807,10/31/2017,44%,54%,44,54,-10,2
808,10/30/2017,44%,54%,44,54,-10,2
809,10/27/2017,43%,55%,43,55,-12,2
810,10/26/2017,43%,55%,43,55,-12,2
811,10/25/2017,42%,56%,42,56,-14,2
812,10/24/2017,43%,56%,43,56,-13,1
813,10/23/2017,41%,58%,41,58,-17,1
814,10/20/2017,43%,55%,43,55,-12,2
815,10/19/2017,41%,57%,41,57,-16,2
816,10/18/2017,43%,55%,43,55,-12,2
817,10/17/2017,41%,57%,41,57,-16,2
818,10/16/2017,43%,56%,43,56,-13,1
819,10/13/2017,43%,55%,43,55,-12,2
820,10/12/2017,44%,55%,44,55,-11,1
821,10/11/2017,43%,56%,43,56,-13,1
822,10/10/2017,43%,56%,43,56,-13,1
823,10/9/2017,44%,55%,44,55,-11,1
824,10/6/2017,46%,53%,46,53,-7,1
825,10/5/2017,45%,54%,45,54,-9,1
826,10/4/2017,44%,55%,44,55,-11,1
827,10/3/2017,42%,57%,42,57,-15,1
828,10/2/2017,42%,57%,42,57,-15,1
829,9/29/2017,45%,54%,45,54,-9,1
830,9/28/2017,43%,56%,43,56,-13,1
831,9/27/2017,43%,56%,43,56,-13,1
832,9/26/2017,42%,56%,42,56,-14,2
833,9/25/2017,44%,54%,44,54,-10,2
834,9/22/2017,43%,55%,43,55,-12,2
835,9/21/2017,43%,55%,43,55,-12,2
836,9/20/2017,42%,56%,42,56,-14,2
837,9/19/2017,43%,55%,43,55,-12,2
838,9/18/2017,44%,55%,44,55,-11,1
839,9/15/2017,43%,55%,43,55,-12,2
840,9/14/2017,44%,54%,44,54,-10,2
841,9/13/2017,42%,56%,42,56,-14,2
842,9/12/2017,44%,54%,44,54,-10,2
843,9/11/2017,44%,55%,44,55,-11,1
844,9/8/2017,46%,53%,46,53,-7,1
845,9/7/2017,45%,54%,45,54,-9,1
846,9/6/2017,45%,53%,45,53,-8,2
847,9/5/2017,44%,54%,44,54,-10,2
848,9/4/2017,43%,55%,43,55,-12,2
849,9/1/2017,42%,56%,42,56,-14,2
850,8/31/2017,41%,58%,41,58,-17,1
851,8/30/2017,41%,58%,41,58,-17,1
852,8/29/2017,41%,58%,41,58,-17,1
853,8/28/2017,42%,57%,42,57,-15,1
854,8/25/2017,42%,56%,42,56,-14,2
855,8/24/2017,42%,56%,42,56,-14,2
856,8/23/2017,41%,57%,41,57,-16,2
857,8/22/2017,43%,56%,43,56,-13,1
858,8/21/2017,42%,57%,42,57,-15,1
859,8/18/2017,42%,57%,42,57,-15,1
860,8/17/2017,40%,59%,40,59,-19,1
861,8/16/2017,40%,58%,40,58,-18,2
862,8/15/2017,42%,57%,42,57,-15,1
863,8/14/2017,43%,55%,43,55,-12,2
864,8/11/2017,45%,53%,45,53,-8,2
865,8/10/2017,44%,54%,44,54,-10,2
866,8/9/2017,42%,56%,42,56,-14,2
867,8/8/2017,41%,57%,41,57,-16,2
868,8/7/2017,41%,57%,41,57,-16,2
869,8/4/2017,39%,59%,39,59,-20,2
870,8/3/2017,39%,60%,39,60,-21,1
871,8/2/2017,38%,62%,38,62,-24,0
872,8/1/2017,39%,61%,39,61,-22,0
873,7/31/2017,39%,61%,39,61,-22,0
874,7/28/2017,41%,59%,41,59,-18,0
875,7/27/2017,41%,59%,41,59,-18,0
876,7/26/2017,43%,57%,43,57,-14,0
877,7/25/2017,42%,58%,42,58,-16,0
878,7/24/2017,44%,56%,44,56,-12,0
879,7/21/2017,43%,57%,43,57,-14,0
880,7/20/2017,43%,57%,43,57,-14,0
881,7/19/2017,42%,58%,42,58,-16,0
882,7/18/2017,43%,57%,43,57,-14,0
883,7/17/2017,43%,57%,43,57,-14,0
884,7/14/2017,43%,57%,43,57,-14,0
885,7/13/2017,44%,56%,44,56,-12,0
886,7/12/2017,45%,55%,45,55,-10,0
887,7/11/2017,45%,55%,45,55,-10,0
888,7/10/2017,45%,55%,45,55,-10,0
889,7/7/2017,45%,55%,45,55,-10,0
890,7/6/2017,44%,56%,44,56,-12,0
891,7/4/2017,44%,56%,44,56,-12,0
892,7/3/2017,44%,56%,44,56,-12,0
893,6/30/2017,46%,54%,46,54,-8,0
894,6/29/2017,45%,55%,45,55,-10,0
895,6/28/2017,46%,54%,46,54,-8,0
896,6/27/2017,46%,54%,46,54,-8,0
897,6/26/2017,47%,53%,47,53,-6,0
898,6/23/2017,46%,54%,46,54,-8,0
899,6/22/2017,46%,54%,46,54,-8,0
900,6/21/2017,45%,55%,45,55,-10,0
901,6/20/2017,47%,53%,47,53,-6,0
902,6/19/2017,48%,51%,48,51,-3,1
903,6/16/2017,50%,50%,50,50,0,0
904,6/15/2017,47%,53%,47,53,-6,0
905,6/14/2017,45%,55%,45,55,-10,0
906,6/13/2017,43%,57%,43,57,-14,0
907,6/12/2017,46%,54%,46,54,-8,0
908,6/9/2017,46%,54%,46,54,-8,0
909,6/8/2017,46%,54%,46,54,-8,0
910,6/7/2017,45%,55%,45,55,-10,0
911,6/6/2017,46%,54%,46,54,-8,0
912,6/5/2017,46%,54%,46,54,-8,0
913,6/2/2017,44%,56%,44,56,-12,0
914,6/1/2017,43%,57%,43,57,-14,0
915,5/31/2017,43%,57%,43,57,-14,0
916,5/30/2017,44%,56%,44,56,-12,0
917,5/29/2017,45%,55%,45,55,-10,0
918,5/26/2017,46%,54%,46,54,-8,0
919,5/25/2017,48%,52%,48,52,-4,0
920,5/24/2017,48%,52%,48,52,-4,0
921,5/23/2017,46%,54%,46,54,-8,0
922,5/22/2017,44%,56%,44,56,-12,0
923,5/19/2017,44%,56%,44,56,-12,0
924,5/18/2017,44%,55%,44,55,-11,1
925,5/17/2017,44%,56%,44,56,-12,0
926,5/16/2017,43%,57%,43,57,-14,0
927,5/15/2017,44%,56%,44,56,-12,0
928,5/12/2017,45%,55%,45,55,-10,0
929,5/11/2017,48%,52%,48,52,-4,0
930,5/10/2017,47%,53%,47,53,-6,0
931,5/9/2017,46%,54%,46,54,-8,0
932,5/8/2017,45%,54%,45,54,-9,1
933,5/5/2017,46%,54%,46,54,-8,0
934,5/4/2017,48%,52%,48,52,-4,0
935,5/3/2017,49%,51%,49,51,-2,0
936,5/2/2017,48%,52%,48,52,-4,0
937,5/1/2017,47%,53%,47,53,-6,0
938,4/28/2017,47%,53%,47,53,-6,0
939,4/27/2017,45%,55%,45,55,-10,0
940,4/26/2017,46%,54%,46,54,-8,0
941,4/25/2017,47%,53%,47,53,-6,0
942,4/24/2017,51%,49%,51,49,2,0
943,4/21/2017,49%,51%,49,51,-2,0
944,4/20/2017,49%,51%,49,51,-2,0
945,4/19/2017,48%,52%,48,52,-4,0
946,4/18/2017,50%,50%,50,50,0,0
947,4/17/2017,50%,50%,50,50,0,0
948,4/14/2017,48%,52%,48,52,-4,0
949,4/13/2017,48%,52%,48,52,-4,0
950,4/12/2017,47%,53%,47,53,-6,0
951,4/11/2017,47%,53%,47,53,-6,0
952,4/10/2017,44%,56%,44,56,-12,0
953,4/7/2017,45%,55%,45,55,-10,0
954,4/6/2017,46%,54%,46,54,-8,0
955,4/5/2017,46%,54%,46,54,-8,0
956,4/4/2017,43%,57%,43,57,-14,0
957,4/3/2017,42%,58%,42,58,-16,0
958,3/31/2017,43%,57%,43,57,-14,0
959,3/30/2017,44%,56%,44,56,-12,0
960,3/29/2017,44%,56%,44,56,-12,0
961,3/28/2017,45%,55%,45,55,-10,0
962,3/27/2017,45%,54%,45,54,-9,1
963,3/24/2017,44%,56%,44,56,-12,0
964,3/23/2017,47%,53%,47,53,-6,0
965,3/22/2017,46%,54%,46,54,-8,0
966,3/21/2017,50%,50%,50,50,0,0
967,3/20/2017,49%,51%,49,51,-2,0
968,3/17/2017,48%,52%,48,52,-4,0
969,3/16/2017,47%,53%,47,53,-6,0
970,3/15/2017,45%,54%,45,54,-9,1
971,3/14/2017,46%,53%,46,53,-7,1
972,3/13/2017,47%,53%,47,53,-6,0
973,3/10/2017,48%,52%,48,52,-4,0
974,3/9/2017,49%,51%,49,51,-2,0
975,3/8/2017,49%,51%,49,51,-2,0
976,3/7/2017,51%,49%,51,49,2,0
977,3/6/2017,52%,48%,52,48,4,0
978,3/3/2017,53%,47%,53,47,6,0
979,3/2/2017,52%,48%,52,48,4,0
980,3/1/2017,50%,50%,50,50,0,0
981,2/28/2017,50%,50%,50,50,0,0
982,2/27/2017,51%,49%,51,49,2,0
983,2/24/2017,53%,47%,53,47,6,0
984,2/23/2017,52%,47%,52,47,5,1
985,2/22/2017,51%,49%,51,49,2,0
986,2/21/2017,50%,50%,50,50,0,0
987,2/20/2017,51%,49%,51,49,2,0
988,2/17/2017,55%,45%,55,45,10,0
989,2/16/2017,55%,45%,55,45,10,0
990,2/15/2017,53%,47%,53,47,6,0
991,2/14/2017,52%,48%,52,48,4,0
992,2/13/2017,52%,48%,52,48,4,0
993,2/10/2017,52%,48%,52,48,4,0
994,2/9/2017,53%,47%,53,47,6,0
995,2/8/2017,53%,47%,53,47,6,0
996,2/7/2017,53%,47%,53,47,6,0
997,2/6/2017,53%,47%,53,47,6,0
998,2/3/2017,54%,46%,54,46,8,0
999,2/2/2017,53%,47%,53,47,6,0
1000,2/1/2017,53%,47%,53,47,6,0
1001,1/31/2017,51%,49%,51,49,2,0
1002,1/30/2017,53%,47%,53,47,6,0
1003,1/27/2017,55%,45%,55,45,10,0
1004,1/26/2017,59%,41%,59,41,18,0
1005,1/25/2017,57%,43%,57,43,14,0
1006,1/24/2017,57%,43%,57,43,14,0
1007,1/23/2017,55%,44%,55,44,11,1
1008,1/20/2017,56%,44%,56,44,12,0
