,Date,Total Approve,Total Disapprove,Relative Approval,Neutral
0,2021-01-19,51,48,3,1
1,2021-01-18,48,51,-3,1
2,2021-01-15,48,52,-4,0
3,2021-01-13,46,53,-7,1
4,2021-01-12,49,50,-1,1
5,2021-01-11,48,51,-3,1
6,2021-01-08,48,50,-2,2
7,2021-01-07,49,50,-1,1
8,2021-01-06,47,51,-4,2
9,2021-01-05,47,51,-4,2
10,2020-12-31,45,54,-9,1
11,2020-12-30,47,52,-5,1
12,2020-12-29,47,52,-5,1
13,2020-12-23,45,52,-7,3
14,2020-12-22,45,53,-8,2
15,2020-12-21,46,52,-6,2
16,2020-12-18,48,50,-2,2
17,2020-12-17,51,48,3,1
18,2020-12-16,48,51,-3,1
19,2020-12-15,47,52,-5,1
20,2020-12-14,46,52,-6,2
21,2020-12-11,49,49,0,2
22,2020-12-10,49,49,0,2
23,2020-12-09,50,49,1,1
24,2020-12-08,49,50,-1,1
25,2020-12-07,48,50,-2,2
26,2020-12-04,49,50,-1,1
27,2020-12-03,50,48,2,2
28,2020-12-02,50,48,2,2
29,2020-12-01,49,49,0,2
30,2020-11-30,49,49,0,2
31,2020-11-25,49,49,0,2
32,2020-11-24,48,50,-2,2
33,2020-11-23,48,50,-2,2
34,2020-11-20,47,51,-4,2
35,2020-11-19,49,50,-1,1
36,2020-11-18,51,48,3,1
37,2020-11-17,52,46,6,2
38,2020-11-16,52,47,5,1
39,2020-11-13,52,47,5,1
40,2020-11-12,52,47,5,1
41,2020-11-11,53,46,7,1
42,2020-11-10,52,47,5,1
43,2020-11-09,52,47,5,1
44,2020-11-06,50,48,2,2
45,2020-11-05,48,50,-2,2
46,2020-11-04,49,50,-1,1
47,2020-11-03,49,50,-1,1
48,2020-11-02,52,48,4,0
49,2020-10-30,51,48,3,1
50,2020-10-29,52,47,5,1
51,2020-10-28,52,47,5,1
52,2020-10-27,51,48,3,1
53,2020-10-26,52,46,6,2
54,2020-10-23,51,48,3,1
55,2020-10-22,52,48,4,0
56,2020-10-21,49,50,-1,1
57,2020-10-20,49,50,-1,1
58,2020-10-19,48,50,-2,2
59,2020-10-16,48,50,-2,2
60,2020-10-15,47,51,-4,2
61,2020-10-14,47,51,-4,2
62,2020-10-13,48,51,-3,1
63,2020-10-12,49,50,-1,1
64,2020-10-09,46,52,-6,2
65,2020-10-08,45,53,-8,2
66,2020-10-07,44,54,-10,2
67,2020-10-06,45,54,-9,1
68,2020-10-05,46,53,-7,1
69,2020-10-02,46,53,-7,1
70,2020-10-01,49,51,-2,0
71,2020-09-30,46,53,-7,1
72,2020-09-29,47,52,-5,1
73,2020-09-28,46,53,-7,1
74,2020-09-25,52,48,4,0
75,2020-09-24,52,48,4,0
76,2020-09-23,50,49,1,1
77,2020-09-22,50,49,1,1
78,2020-09-21,51,48,3,1
79,2020-09-18,53,46,7,1
80,2020-09-17,51,48,3,1
81,2020-09-16,52,46,6,2
82,2020-09-15,51,48,3,1
83,2020-09-14,51,48,3,1
84,2020-09-11,48,51,-3,1
85,2020-09-10,48,51,-3,1
86,2020-09-09,48,51,-3,1
87,2020-09-08,50,50,0,0
88,2020-09-07,51,49,2,0
89,2020-09-04,52,48,4,0
90,2020-09-03,50,49,1,1
91,2020-09-02,49,50,-1,1
92,2020-09-01,47,51,-4,2
93,2020-08-31,47,51,-4,2
94,2020-08-28,46,52,-6,2
95,2020-08-27,47,51,-4,2
96,2020-08-26,47,51,-4,2
97,2020-08-25,49,49,0,2
98,2020-08-24,51,47,4,2
99,2020-08-21,51,47,4,2
100,2020-08-20,51,48,3,1
101,2020-08-19,47,51,-4,2
102,2020-08-18,48,50,-2,2
103,2020-08-17,47,51,-4,2
104,2020-08-14,47,52,-5,1
105,2020-08-13,47,52,-5,1
106,2020-08-12,48,51,-3,1
107,2020-08-11,49,51,-2,0
108,2020-08-10,48,51,-3,1
109,2020-08-07,48,51,-3,1
110,2020-08-06,46,52,-6,2
111,2020-08-05,48,50,-2,2
112,2020-08-04,49,49,0,2
113,2020-08-03,51,47,4,2
114,2020-07-31,50,48,2,2
115,2020-07-30,48,51,-3,1
116,2020-07-29,45,54,-9,1
117,2020-07-28,45,54,-9,1
118,2020-07-27,46,52,-6,2
119,2020-07-24,49,49,0,2
120,2020-07-23,49,49,0,2
121,2020-07-22,49,50,-1,1
122,2020-07-21,48,51,-3,1
123,2020-07-20,46,53,-7,1
124,2020-07-17,45,53,-8,2
125,2020-07-16,47,51,-4,2
126,2020-07-15,48,50,-2,2
127,2020-07-14,47,51,-4,2
128,2020-07-13,45,54,-9,1
129,2020-07-10,45,53,-8,2
130,2020-07-09,45,54,-9,1
131,2020-07-08,44,54,-10,2
132,2020-07-07,45,53,-8,2
133,2020-07-06,47,52,-5,1
134,2020-07-03,47,52,-5,1
135,2020-07-02,46,52,-6,2
136,2020-07-01,44,54,-10,2
137,2020-06-30,43,55,-12,2
138,2020-06-29,42,55,-13,3
139,2020-06-26,44,53,-9,3
140,2020-06-25,47,51,-4,2
141,2020-06-24,47,52,-5,1
142,2020-06-23,45,53,-8,2
143,2020-06-22,46,52,-6,2
144,2020-06-19,47,51,-4,2
145,2020-06-18,47,51,-4,2
146,2020-06-17,46,53,-7,1
147,2020-06-16,44,55,-11,1
148,2020-06-15,43,56,-13,1
149,2020-06-12,43,55,-12,2
150,2020-06-11,43,56,-13,1
151,2020-06-10,44,55,-11,1
152,2020-06-09,44,55,-11,1
153,2020-06-08,47,52,-5,1
154,2020-06-05,48,51,-3,1
155,2020-06-04,46,52,-6,2
156,2020-06-03,44,54,-10,2
157,2020-06-02,46,53,-7,1
158,2020-06-01,47,52,-5,1
159,2020-05-29,46,53,-7,1
160,2020-05-28,45,54,-9,1
161,2020-05-27,42,57,-15,1
162,2020-05-26,44,55,-11,1
163,2020-05-25,43,55,-12,2
164,2020-05-22,46,53,-7,1
165,2020-05-21,45,54,-9,1
166,2020-05-20,46,53,-7,1
167,2020-05-19,46,53,-7,1
168,2020-05-18,48,51,-3,1
169,2020-05-15,49,50,-1,1
170,2020-05-14,48,51,-3,1
171,2020-05-13,47,51,-4,2
172,2020-05-12,46,52,-6,2
173,2020-05-11,48,50,-2,2
174,2020-05-08,49,49,0,2
175,2020-05-07,49,48,1,3
176,2020-05-06,49,49,0,2
177,2020-05-05,47,52,-5,1
178,2020-05-04,46,53,-7,1
179,2020-05-01,45,53,-8,2
180,2020-04-30,46,52,-6,2
181,2020-04-29,46,52,-6,2
182,2020-04-28,44,54,-10,2
183,2020-04-27,44,54,-10,2
184,2020-04-24,45,54,-9,1
185,2020-04-23,44,55,-11,1
186,2020-04-22,44,55,-11,1
187,2020-04-21,44,55,-11,1
188,2020-04-20,46,53,-7,1
189,2020-04-17,46,53,-7,1
190,2020-04-16,46,53,-7,1
191,2020-04-15,45,54,-9,1
192,2020-04-14,44,55,-11,1
193,2020-04-13,43,56,-13,1
194,2020-04-10,43,56,-13,1
195,2020-04-09,46,52,-6,2
196,2020-04-08,47,52,-5,1
197,2020-04-07,47,51,-4,2
198,2020-04-06,44,53,-9,3
199,2020-04-03,44,53,-9,3
200,2020-04-02,48,50,-2,2
201,2020-04-01,48,51,-3,1
202,2020-03-31,47,52,-5,1
203,2020-03-30,45,54,-9,1
204,2020-03-27,46,52,-6,2
205,2020-03-26,46,52,-6,2
206,2020-03-25,46,53,-7,1
207,2020-03-24,46,52,-6,2
208,2020-03-23,45,52,-7,3
209,2020-03-20,46,52,-6,2
210,2020-03-19,47,52,-5,1
211,2020-03-18,46,53,-7,1
212,2020-03-17,46,53,-7,1
213,2020-03-16,47,52,-5,1
214,2020-03-13,49,50,-1,1
215,2020-03-12,48,50,-2,2
216,2020-03-11,47,52,-5,1
217,2020-03-10,48,51,-3,1
218,2020-03-09,48,51,-3,1
219,2020-03-06,47,51,-4,2
220,2020-03-05,48,50,-2,2
221,2020-03-04,48,49,-1,3
222,2020-03-03,47,51,-4,2
223,2020-03-02,46,52,-6,2
224,2020-02-28,47,52,-5,1
225,2020-02-27,52,47,5,1
226,2020-02-26,51,48,3,1
227,2020-02-25,52,47,5,1
228,2020-02-24,49,50,-1,1
229,2020-02-21,49,51,-2,0
230,2020-02-20,49,50,-1,1
231,2020-02-19,50,49,1,1
232,2020-02-18,50,49,1,1
233,2020-02-17,49,50,-1,1
234,2020-02-14,49,49,0,2
235,2020-02-13,50,49,1,1
236,2020-02-12,50,48,2,2
237,2020-02-11,49,49,0,2
238,2020-02-10,50,48,2,2
239,2020-02-07,49,49,0,2
240,2020-02-06,50,49,1,1
241,2020-02-05,48,50,-2,2
242,2020-02-04,48,51,-3,1
243,2020-02-03,48,50,-2,2
244,2020-01-31,50,49,1,1
245,2020-01-30,50,49,1,1
246,2020-01-29,49,51,-2,0
247,2020-01-28,49,50,-1,1
248,2020-01-27,50,49,1,1
249,2020-01-24,49,49,0,2
250,2020-01-23,48,50,-2,2
251,2020-01-22,46,53,-7,1
252,2020-01-21,47,53,-6,0
253,2020-01-20,48,51,-3,1
254,2020-01-17,49,50,-1,1
255,2020-01-16,51,47,4,2
256,2020-01-15,49,50,-1,1
257,2020-01-14,49,50,-1,1
258,2020-01-13,48,50,-2,2
259,2020-01-10,48,51,-3,1
260,2020-01-09,48,51,-3,1
261,2020-01-08,46,53,-7,1
262,2020-01-07,48,50,-2,2
263,2020-01-06,49,50,-1,1
264,2020-01-03,50,50,0,0
265,2019-12-31,48,51,-3,1
266,2019-12-30,46,53,-7,1
267,2019-12-27,46,53,-7,1
268,2019-12-24,48,51,-3,1
269,2019-12-23,48,51,-3,1
270,2019-12-20,50,48,2,2
271,2019-12-19,49,49,0,2
272,2019-12-18,49,49,0,2
273,2019-12-17,48,49,-1,3
274,2019-12-16,47,51,-4,2
275,2019-12-13,49,49,0,2
276,2019-12-12,49,50,-1,1
277,2019-12-11,51,48,3,1
278,2019-12-10,50,49,1,1
279,2019-12-09,51,48,3,1
280,2019-12-06,51,48,3,1
281,2019-12-05,52,47,5,1
282,2019-12-04,49,50,-1,1
283,2019-12-03,48,50,-2,2
284,2019-12-02,46,53,-7,1
285,2019-11-26,46,53,-7,1
286,2019-11-25,44,55,-11,1
287,2019-11-22,46,52,-6,2
288,2019-11-21,46,53,-7,1
289,2019-11-20,48,51,-3,1
290,2019-11-19,48,51,-3,1
291,2019-11-18,50,49,1,1
292,2019-11-15,50,49,1,1
293,2019-11-14,48,51,-3,1
294,2019-11-13,46,53,-7,1
295,2019-11-12,44,54,-10,2
296,2019-11-11,47,52,-5,1
297,2019-11-08,49,50,-1,1
298,2019-11-07,50,49,1,1
299,2019-11-06,46,52,-6,2
300,2019-11-05,46,54,-8,0
301,2019-11-04,44,55,-11,1
302,2019-11-01,45,54,-9,1
303,2019-10-31,45,54,-9,1
304,2019-10-30,47,52,-5,1
305,2019-10-29,46,53,-7,1
306,2019-10-28,45,54,-9,1
307,2019-10-25,43,56,-13,1
308,2019-10-24,43,54,-11,3
309,2019-10-23,44,53,-9,3
310,2019-10-22,45,52,-7,3
311,2019-10-21,45,53,-8,2
312,2019-10-18,47,52,-5,1
313,2019-10-17,48,51,-3,1
314,2019-10-16,50,49,1,1
315,2019-10-15,49,50,-1,1
316,2019-10-14,49,50,-1,1
317,2019-10-11,49,50,-1,1
318,2019-10-10,47,51,-4,2
319,2019-10-09,46,52,-6,2
320,2019-10-08,45,52,-7,3
321,2019-10-07,47,51,-4,2
322,2019-10-04,48,50,-2,2
323,2019-10-03,47,52,-5,1
324,2019-10-02,48,51,-3,1
325,2019-10-01,48,50,-2,2
326,2019-09-30,49,50,-1,1
327,2019-09-27,48,50,-2,2
328,2019-09-26,49,49,0,2
329,2019-09-25,51,47,4,2
330,2019-09-24,53,45,8,2
331,2019-09-23,52,46,6,2
332,2019-09-20,52,47,5,1
333,2019-09-19,49,50,-1,1
334,2019-09-18,51,48,3,1
335,2019-09-17,49,50,-1,1
336,2019-09-16,50,49,1,1
337,2019-09-13,47,52,-5,1
338,2019-09-12,48,51,-3,1
339,2019-09-11,47,53,-6,0
340,2019-09-10,47,53,-6,0
341,2019-09-09,46,53,-7,1
342,2019-09-06,46,52,-6,2
343,2019-09-05,46,52,-6,2
344,2019-09-04,46,52,-6,2
345,2019-09-03,46,53,-7,1
346,2019-09-02,45,54,-9,1
347,2019-08-30,47,51,-4,2
348,2019-08-29,47,51,-4,2
349,2019-08-28,47,52,-5,1
350,2019-08-27,47,51,-4,2
351,2019-08-26,48,50,-2,2
352,2019-08-23,50,48,2,2
353,2019-08-22,48,50,-2,2
354,2019-08-21,46,52,-6,2
355,2019-08-20,44,54,-10,2
356,2019-08-19,46,53,-7,1
357,2019-08-16,46,52,-6,2
358,2019-08-15,46,53,-7,1
359,2019-08-14,45,54,-9,1
360,2019-08-13,46,53,-7,1
361,2019-08-12,47,52,-5,1
362,2019-08-09,47,52,-5,1
363,2019-08-08,47,51,-4,2
364,2019-08-07,47,51,-4,2
365,2019-08-06,49,49,0,2
366,2019-08-05,48,50,-2,2
367,2019-08-02,48,50,-2,2
368,2019-08-01,48,51,-3,1
369,2019-07-31,47,52,-5,1
370,2019-07-30,47,51,-4,2
371,2019-07-29,47,52,-5,1
372,2019-07-26,47,51,-4,2
373,2019-07-25,48,51,-3,1
374,2019-07-24,48,50,-2,2
375,2019-07-23,50,49,1,1
376,2019-07-22,49,49,0,2
377,2019-07-19,50,48,2,2
378,2019-07-18,49,49,0,2
379,2019-07-17,50,48,2,2
380,2019-07-16,48,50,-2,2
381,2019-07-15,46,52,-6,2
382,2019-07-12,46,52,-6,2
383,2019-07-11,48,51,-3,1
384,2019-07-10,49,50,-1,1
385,2019-07-09,49,51,-2,0
386,2019-07-08,50,49,1,1
387,2019-07-03,49,50,-1,1
388,2019-07-02,48,51,-3,1
389,2019-07-01,47,51,-4,2
390,2019-06-28,49,50,-1,1
391,2019-06-27,50,48,2,2
392,2019-06-26,48,50,-2,2
393,2019-06-25,47,51,-4,2
394,2019-06-24,48,50,-2,2
395,2019-06-21,49,49,0,2
396,2019-06-20,50,48,2,2
397,2019-06-19,47,50,-3,3
398,2019-06-18,48,51,-3,1
399,2019-06-17,48,50,-2,2
400,2019-06-14,51,47,4,2
401,2019-06-13,50,47,3,3
402,2019-06-12,51,47,4,2
403,2019-06-11,49,49,0,2
404,2019-06-10,50,48,2,2
405,2019-06-07,48,50,-2,2
406,2019-06-06,50,49,1,1
407,2019-06-05,49,50,-1,1
408,2019-06-04,49,50,-1,1
409,2019-06-03,47,52,-5,1
410,2019-05-31,48,51,-3,1
411,2019-05-30,48,52,-4,0
412,2019-05-29,47,52,-5,1
413,2019-05-28,46,53,-7,1
414,2019-05-27,46,53,-7,1
415,2019-05-24,46,52,-6,2
416,2019-05-23,47,52,-5,1
417,2019-05-22,46,53,-7,1
418,2019-05-21,46,53,-7,1
419,2019-05-20,44,54,-10,2
420,2019-05-17,45,53,-8,2
421,2019-05-16,45,53,-8,2
422,2019-05-15,48,50,-2,2
423,2019-05-14,49,49,0,2
424,2019-05-13,50,49,1,1
425,2019-05-10,49,50,-1,1
426,2019-05-09,49,50,-1,1
427,2019-05-08,49,49,0,2
428,2019-05-07,49,49,0,2
429,2019-05-06,50,48,2,2
430,2019-05-03,50,47,3,3
431,2019-05-02,51,47,4,2
432,2019-05-01,50,48,2,2
433,2019-04-30,49,49,0,2
434,2019-04-29,48,49,-1,3
435,2019-04-26,49,49,0,2
436,2019-04-25,50,48,2,2
437,2019-04-24,49,49,0,2
438,2019-04-23,49,49,0,2
439,2019-04-22,47,51,-4,2
440,2019-04-19,49,51,-2,0
441,2019-04-18,50,50,0,0
442,2019-04-17,52,48,4,0
443,2019-04-16,52,48,4,0
444,2019-04-15,50,49,1,1
445,2019-04-12,49,50,-1,1
446,2019-04-11,50,49,1,1
447,2019-04-10,51,47,4,2
448,2019-04-09,53,45,8,2
449,2019-04-08,51,47,4,2
450,2019-04-05,51,47,4,2
451,2019-04-04,49,49,0,2
452,2019-04-03,50,48,2,2
453,2019-04-02,48,51,-3,1
454,2019-04-01,51,49,2,0
455,2019-03-29,49,50,-1,1
456,2019-03-28,50,49,1,1
457,2019-03-27,49,50,-1,1
458,2019-03-26,47,52,-5,1
459,2019-03-25,45,54,-9,1
460,2019-03-22,45,53,-8,2
461,2019-03-21,49,49,0,2
462,2019-03-20,48,50,-2,2
463,2019-03-19,47,52,-5,1
464,2019-03-18,47,51,-4,2
465,2019-03-15,48,51,-3,1
466,2019-03-14,49,50,-1,1
467,2019-03-13,47,52,-5,1
468,2019-03-12,47,51,-4,2
469,2019-03-11,49,50,-1,1
470,2019-03-08,50,49,1,1
471,2019-03-07,50,49,1,1
472,2019-03-06,48,51,-3,1
473,2019-03-05,48,51,-3,1
474,2019-03-04,47,51,-4,2
475,2019-03-01,49,49,0,2
476,2019-02-28,49,50,-1,1
477,2019-02-27,49,49,0,2
478,2019-02-26,49,50,-1,1
479,2019-02-25,49,49,0,2
480,2019-02-22,49,49,0,2
481,2019-02-21,49,50,-1,1
482,2019-02-20,49,51,-2,0
483,2019-02-19,49,50,-1,1
484,2019-02-18,50,49,1,1
485,2019-02-15,50,49,1,1
486,2019-02-14,50,49,1,1
487,2019-02-13,50,49,1,1
488,2019-02-12,50,48,2,2
489,2019-02-11,52,47,5,1
490,2019-02-08,50,49,1,1
491,2019-02-07,49,50,-1,1
492,2019-02-06,48,51,-3,1
493,2019-02-05,48,51,-3,1
494,2019-02-04,45,54,-9,1
495,2019-02-01,43,57,-14,0
496,2019-01-31,43,56,-13,1
497,2019-01-30,43,56,-13,1
498,2019-01-29,45,54,-9,1
499,2019-01-28,45,54,-9,1
500,2019-01-25,45,54,-9,1
501,2019-01-24,44,55,-11,1
502,2019-01-23,44,56,-12,0
503,2019-01-22,44,56,-12,0
504,2019-01-21,44,56,-12,0
505,2019-01-18,44,55,-11,1
506,2019-01-17,44,55,-11,1
507,2019-01-16,43,55,-12,2
508,2019-01-15,43,55,-12,2
509,2019-01-14,43,55,-12,2
510,2019-01-11,45,54,-9,1
511,2019-01-10,45,53,-8,2
512,2019-01-09,47,52,-5,1
513,2019-01-08,46,53,-7,1
514,2019-01-07,46,53,-7,1
515,2019-01-04,46,53,-7,1
516,2019-01-03,47,51,-4,2
517,2018-12-28,47,52,-5,1
518,2018-12-27,47,52,-5,1
519,2018-12-24,46,52,-6,2
520,2018-12-21,49,50,-1,1
521,2018-12-20,48,51,-3,1
522,2018-12-19,47,52,-5,1
523,2018-12-18,46,53,-7,1
524,2018-12-17,47,51,-4,2
525,2018-12-14,48,50,-2,2
526,2018-12-13,49,48,1,3
527,2018-12-12,48,50,-2,2
528,2018-12-11,49,49,0,2
529,2018-12-10,48,51,-3,1
530,2018-12-07,50,49,1,1
531,2018-12-06,49,50,-1,1
532,2018-12-05,50,48,2,2
533,2018-12-04,48,51,-3,1
534,2018-12-03,48,50,-2,2
535,2018-11-30,47,51,-4,2
536,2018-11-29,47,51,-4,2
537,2018-11-28,48,50,-2,2
538,2018-11-27,49,49,0,2
539,2018-11-21,51,48,3,1
540,2018-11-20,50,49,1,1
541,2018-11-19,50,49,1,1
542,2018-11-16,49,50,-1,1
543,2018-11-15,48,50,-2,2
544,2018-11-14,46,52,-6,2
545,2018-11-13,46,52,-6,2
546,2018-11-12,46,52,-6,2
547,2018-11-09,48,50,-2,2
548,2018-11-08,48,50,-2,2
549,2018-11-07,48,50,-2,2
550,2018-11-06,48,50,-2,2
551,2018-11-05,50,49,1,1
552,2018-11-02,51,47,4,2
553,2018-11-01,49,50,-1,1
554,2018-10-31,49,50,-1,1
555,2018-10-30,48,51,-3,1
556,2018-10-29,50,49,1,1
557,2018-10-26,48,51,-3,1
558,2018-10-25,47,51,-4,2
559,2018-10-24,46,52,-6,2
560,2018-10-23,48,51,-3,1
561,2018-10-22,47,52,-5,1
562,2018-10-19,47,52,-5,1
563,2018-10-18,47,52,-5,1
564,2018-10-17,49,50,-1,1
565,2018-10-16,51,48,3,1
566,2018-10-15,51,49,2,0
567,2018-10-12,49,50,-1,1
568,2018-10-11,49,50,-1,1
569,2018-10-10,49,49,0,2
570,2018-10-09,51,47,4,2
571,2018-10-08,51,47,4,2
572,2018-10-05,51,48,3,1
573,2018-10-04,50,49,1,1
574,2018-10-03,49,50,-1,1
575,2018-10-02,48,50,-2,2
576,2018-10-01,48,50,-2,2
577,2018-09-28,47,51,-4,2
578,2018-09-27,47,52,-5,1
579,2018-09-26,47,51,-4,2
580,2018-09-25,47,50,-3,3
581,2018-09-24,49,50,-1,1
582,2018-09-21,49,50,-1,1
583,2018-09-20,48,50,-2,2
584,2018-09-19,47,52,-5,1
585,2018-09-18,48,51,-3,1
586,2018-09-17,49,50,-1,1
587,2018-09-14,47,51,-4,2
588,2018-09-13,46,52,-6,2
589,2018-09-12,45,53,-8,2
590,2018-09-11,47,51,-4,2
591,2018-09-10,48,51,-3,1
592,2018-09-07,48,52,-4,0
593,2018-09-06,46,53,-7,1
594,2018-09-05,44,54,-10,2
595,2018-09-04,45,53,-8,2
596,2018-09-03,47,51,-4,2
597,2018-08-31,48,50,-2,2
598,2018-08-30,48,51,-3,1
599,2018-08-29,47,53,-6,0
600,2018-08-28,46,53,-7,1
601,2018-08-27,46,54,-8,0
602,2018-08-24,46,53,-7,1
603,2018-08-23,46,52,-6,2
604,2018-08-22,46,52,-6,2
605,2018-08-21,46,53,-7,1
606,2018-08-20,48,52,-4,0
607,2018-08-17,48,51,-3,1
608,2018-08-16,49,50,-1,1
609,2018-08-15,49,49,0,2
610,2018-08-14,50,49,1,1
611,2018-08-13,48,50,-2,2
612,2018-08-10,46,52,-6,2
613,2018-08-09,47,51,-4,2
614,2018-08-08,47,51,-4,2
615,2018-08-07,47,51,-4,2
616,2018-08-06,47,51,-4,2
617,2018-08-03,48,50,-2,2
618,2018-08-02,50,49,1,1
619,2018-08-01,48,50,-2,2
620,2018-07-31,48,50,-2,2
621,2018-07-30,47,51,-4,2
622,2018-07-27,46,52,-6,2
623,2018-07-26,46,53,-7,1
624,2018-07-25,46,52,-6,2
625,2018-07-24,46,53,-7,1
626,2018-07-23,46,53,-7,1
627,2018-07-20,44,55,-11,1
628,2018-07-19,45,54,-9,1
629,2018-07-18,44,54,-10,2
630,2018-07-17,46,53,-7,1
631,2018-07-16,45,54,-9,1
632,2018-07-13,46,53,-7,1
633,2018-07-12,46,52,-6,2
634,2018-07-11,47,51,-4,2
635,2018-07-10,47,51,-4,2
636,2018-07-09,47,52,-5,1
637,2018-07-06,47,52,-5,1
638,2018-07-03,48,51,-3,1
639,2018-07-02,48,51,-3,1
640,2018-06-29,47,52,-5,1
641,2018-06-28,46,53,-7,1
642,2018-06-27,45,54,-9,1
643,2018-06-26,46,52,-6,2
644,2018-06-25,46,52,-6,2
645,2018-06-22,46,52,-6,2
646,2018-06-21,46,52,-6,2
647,2018-06-20,48,50,-2,2
648,2018-06-19,48,50,-2,2
649,2018-06-18,48,50,-2,2
650,2018-06-15,47,51,-4,2
651,2018-06-14,49,49,0,2
652,2018-06-13,49,49,0,2
653,2018-06-12,49,50,-1,1
654,2018-06-11,47,52,-5,1
655,2018-06-08,47,51,-4,2
656,2018-06-07,49,49,0,2
657,2018-06-06,49,49,0,2
658,2018-06-05,48,50,-2,2
659,2018-06-04,48,50,-2,2
660,2018-06-01,48,50,-2,2
661,2018-05-31,47,52,-5,1
662,2018-05-30,47,52,-5,1
663,2018-05-29,48,51,-3,1
664,2018-05-28,49,50,-1,1
665,2018-05-25,49,50,-1,1
666,2018-05-24,49,50,-1,1
667,2018-05-23,48,51,-3,1
668,2018-05-22,50,49,1,1
669,2018-05-21,47,51,-4,2
670,2018-05-18,50,49,1,1
671,2018-05-17,49,50,-1,1
672,2018-05-16,48,50,-2,2
673,2018-05-15,47,52,-5,1
674,2018-05-14,47,52,-5,1
675,2018-05-11,49,49,0,2
676,2018-05-10,48,50,-2,2
677,2018-05-09,47,51,-4,2
678,2018-05-08,47,51,-4,2
679,2018-05-07,49,49,0,2
680,2018-05-04,51,49,2,0
681,2018-05-03,50,49,1,1
682,2018-05-02,49,49,0,2
683,2018-05-01,48,50,-2,2
684,2018-04-30,47,52,-5,1
685,2018-04-27,47,52,-5,1
686,2018-04-26,47,52,-5,1
687,2018-04-25,48,50,-2,2
688,2018-04-24,48,50,-2,2
689,2018-04-23,48,50,-2,2
690,2018-04-20,49,50,-1,1
691,2018-04-19,48,51,-3,1
692,2018-04-18,50,49,1,1
693,2018-04-17,49,50,-1,1
694,2018-04-16,51,48,3,1
695,2018-04-13,50,49,1,1
696,2018-04-12,50,49,1,1
697,2018-04-11,49,50,-1,1
698,2018-04-10,48,51,-3,1
699,2018-04-09,48,52,-4,0
700,2018-04-06,47,52,-5,1
701,2018-04-05,47,51,-4,2
702,2018-04-04,51,48,3,1
703,2018-04-03,49,50,-1,1
704,2018-04-02,50,49,1,1
705,2018-03-30,47,52,-5,1
706,2018-03-29,45,53,-8,2
707,2018-03-28,45,53,-8,2
708,2018-03-27,46,53,-7,1
709,2018-03-26,46,52,-6,2
710,2018-03-23,46,52,-6,2
711,2018-03-22,47,52,-5,1
712,2018-03-21,46,52,-6,2
713,2018-03-20,47,52,-5,1
714,2018-03-19,47,52,-5,1
715,2018-03-16,47,52,-5,1
716,2018-03-15,46,53,-7,1
717,2018-03-14,47,52,-5,1
718,2018-03-13,48,51,-3,1
719,2018-03-12,45,53,-8,2
720,2018-03-09,44,54,-10,2
721,2018-03-08,45,54,-9,1
722,2018-03-07,46,53,-7,1
723,2018-03-06,48,52,-4,0
724,2018-03-05,48,52,-4,0
725,2018-03-02,49,50,-1,1
726,2018-03-01,49,50,-1,1
727,2018-02-28,49,50,-1,1
728,2018-02-27,50,48,2,2
729,2018-02-26,49,49,0,2
730,2018-02-23,50,49,1,1
731,2018-02-22,48,51,-3,1
732,2018-02-21,48,51,-3,1
733,2018-02-20,46,53,-7,1
734,2018-02-19,47,52,-5,1
735,2018-02-16,47,52,-5,1
736,2018-02-15,48,51,-3,1
737,2018-02-14,47,52,-5,1
738,2018-02-13,48,50,-2,2
739,2018-02-12,48,50,-2,2
740,2018-02-09,49,50,-1,1
741,2018-02-08,48,50,-2,2
742,2018-02-07,48,51,-3,1
743,2018-02-06,49,50,-1,1
744,2018-02-05,49,49,0,2
745,2018-02-02,49,49,0,2
746,2018-02-01,45,53,-8,2
747,2018-01-31,44,54,-10,2
748,2018-01-30,43,56,-13,1
749,2018-01-29,43,56,-13,1
750,2018-01-26,44,55,-11,1
751,2018-01-25,45,54,-9,1
752,2018-01-24,44,55,-11,1
753,2018-01-23,43,57,-14,0
754,2018-01-22,42,56,-14,2
755,2018-01-19,45,54,-9,1
756,2018-01-18,45,54,-9,1
757,2018-01-17,45,54,-9,1
758,2018-01-16,45,54,-9,1
759,2018-01-15,46,52,-6,2
760,2018-01-12,46,53,-7,1
761,2018-01-11,45,53,-8,2
762,2018-01-10,44,55,-11,1
763,2018-01-09,43,56,-13,1
764,2018-01-08,42,56,-14,2
765,2018-01-05,44,54,-10,2
766,2018-01-04,45,53,-8,2
767,2018-01-03,44,54,-10,2
768,2017-12-29,45,53,-8,2
769,2017-12-28,46,53,-7,1
770,2017-12-27,45,53,-8,2
771,2017-12-22,44,54,-10,2
772,2017-12-21,43,55,-12,2
773,2017-12-20,44,54,-10,2
774,2017-12-19,43,55,-12,2
775,2017-12-18,42,55,-13,3
776,2017-12-15,40,57,-17,3
777,2017-12-14,41,57,-16,2
778,2017-12-13,41,57,-16,2
779,2017-12-12,41,57,-16,2
780,2017-12-11,42,56,-14,2
781,2017-12-08,42,56,-14,2
782,2017-12-07,44,55,-11,1
783,2017-12-06,42,56,-14,2
784,2017-12-05,43,55,-12,2
785,2017-12-04,42,56,-14,2
786,2017-12-01,44,55,-11,1
787,2017-11-30,42,56,-14,2
788,2017-11-29,41,57,-16,2
789,2017-11-28,42,56,-14,2
790,2017-11-27,43,55,-12,2
791,2017-11-22,44,54,-10,2
792,2017-11-21,43,56,-13,1
793,2017-11-20,41,57,-16,2
794,2017-11-17,42,56,-14,2
795,2017-11-16,41,57,-16,2
796,2017-11-15,45,53,-8,2
797,2017-11-14,44,54,-10,2
798,2017-11-13,46,53,-7,1
799,2017-11-10,44,55,-11,1
800,2017-11-09,43,56,-13,1
801,2017-11-08,42,57,-15,1
802,2017-11-07,43,56,-13,1
803,2017-11-06,44,55,-11,1
804,2017-11-03,43,55,-12,2
805,2017-11-02,43,56,-13,1
806,2017-11-01,43,55,-12,2
807,2017-10-31,44,54,-10,2
808,2017-10-30,44,54,-10,2
809,2017-10-27,43,55,-12,2
810,2017-10-26,43,55,-12,2
811,2017-10-25,42,56,-14,2
812,2017-10-24,43,56,-13,1
813,2017-10-23,41,58,-17,1
814,2017-10-20,43,55,-12,2
815,2017-10-19,41,57,-16,2
816,2017-10-18,43,55,-12,2
817,2017-10-17,41,57,-16,2
818,2017-10-16,43,56,-13,1
819,2017-10-13,43,55,-12,2
820,2017-10-12,44,55,-11,1
821,2017-10-11,43,56,-13,1
822,2017-10-10,43,56,-13,1
823,2017-10-09,44,55,-11,1
824,2017-10-06,46,53,-7,1
825,2017-10-05,45,54,-9,1
826,2017-10-04,44,55,-11,1
827,2017-10-03,42,57,-15,1
828,2017-10-02,42,57,-15,1
829,2017-09-29,45,54,-9,1
830,2017-09-28,43,56,-13,1
831,2017-09-27,43,56,-13,1
832,2017-09-26,42,56,-14,2
833,2017-09-25,44,54,-10,2
834,2017-09-22,43,55,-12,2
835,2017-09-21,43,55,-12,2
836,2017-09-20,42,56,-14,2
837,2017-09-19,43,55,-12,2
838,2017-09-18,44,55,-11,1
839,2017-09-15,43,55,-12,2
840,2017-09-14,44,54,-10,2
841,2017-09-13,42,56,-14,2
842,2017-09-12,44,54,-10,2
843,2017-09-11,44,55,-11,1
844,2017-09-08,46,53,-7,1
845,2017-09-07,45,54,-9,1
846,2017-09-06,45,53,-8,2
847,2017-09-05,44,54,-10,2
848,2017-09-04,43,55,-12,2
849,2017-09-01,42,56,-14,2
850,2017-08-31,41,58,-17,1
851,2017-08-30,41,58,-17,1
852,2017-08-29,41,58,-17,1
853,2017-08-28,42,57,-15,1
854,2017-08-25,42,56,-14,2
855,2017-08-24,42,56,-14,2
856,2017-08-23,41,57,-16,2
857,2017-08-22,43,56,-13,1
858,2017-08-21,42,57,-15,1
859,2017-08-18,42,57,-15,1
860,2017-08-17,40,59,-19,1
861,2017-08-16,40,58,-18,2
862,2017-08-15,42,57,-15,1
863,2017-08-14,43,55,-12,2
864,2017-08-11,45,53,-8,2
865,2017-08-10,44,54,-10,2
866,2017-08-09,42,56,-14,2
867,2017-08-08,41,57,-16,2
868,2017-08-07,41,57,-16,2
869,2017-08-04,39,59,-20,2
870,2017-08-03,39,60,-21,1
871,2017-08-02,38,62,-24,0
872,2017-08-01,39,61,-22,0
873,2017-07-31,39,61,-22,0
874,2017-07-28,41,59,-18,0
875,2017-07-27,41,59,-18,0
876,2017-07-26,43,57,-14,0
877,2017-07-25,42,58,-16,0
878,2017-07-24,44,56,-12,0
879,2017-07-21,43,57,-14,0
880,2017-07-20,43,57,-14,0
881,2017-07-19,42,58,-16,0
882,2017-07-18,43,57,-14,0
883,2017-07-17,43,57,-14,0
884,2017-07-14,43,57,-14,0
885,2017-07-13,44,56,-12,0
886,2017-07-12,45,55,-10,0
887,2017-07-11,45,55,-10,0
888,2017-07-10,45,55,-10,0
889,2017-07-07,45,55,-10,0
890,2017-07-06,44,56,-12,0
891,2017-07-04,44,56,-12,0
892,2017-07-03,44,56,-12,0
893,2017-06-30,46,54,-8,0
894,2017-06-29,45,55,-10,0
895,2017-06-28,46,54,-8,0
896,2017-06-27,46,54,-8,0
897,2017-06-26,47,53,-6,0
898,2017-06-23,46,54,-8,0
899,2017-06-22,46,54,-8,0
900,2017-06-21,45,55,-10,0
901,2017-06-20,47,53,-6,0
902,2017-06-19,48,51,-3,1
903,2017-06-16,50,50,0,0
904,2017-06-15,47,53,-6,0
905,2017-06-14,45,55,-10,0
906,2017-06-13,43,57,-14,0
907,2017-06-12,46,54,-8,0
908,2017-06-09,46,54,-8,0
909,2017-06-08,46,54,-8,0
910,2017-06-07,45,55,-10,0
911,2017-06-06,46,54,-8,0
912,2017-06-05,46,54,-8,0
913,2017-06-02,44,56,-12,0
914,2017-06-01,43,57,-14,0
915,2017-05-31,43,57,-14,0
916,2017-05-30,44,56,-12,0
917,2017-05-29,45,55,-10,0
918,2017-05-26,46,54,-8,0
919,2017-05-25,48,52,-4,0
920,2017-05-24,48,52,-4,0
921,2017-05-23,46,54,-8,0
922,2017-05-22,44,56,-12,0
923,2017-05-19,44,56,-12,0
924,2017-05-18,44,55,-11,1
925,2017-05-17,44,56,-12,0
926,2017-05-16,43,57,-14,0
927,2017-05-15,44,56,-12,0
928,2017-05-12,45,55,-10,0
929,2017-05-11,48,52,-4,0
930,2017-05-10,47,53,-6,0
931,2017-05-09,46,54,-8,0
932,2017-05-08,45,54,-9,1
933,2017-05-05,46,54,-8,0
934,2017-05-04,48,52,-4,0
935,2017-05-03,49,51,-2,0
936,2017-05-02,48,52,-4,0
937,2017-05-01,47,53,-6,0
938,2017-04-28,47,53,-6,0
939,2017-04-27,45,55,-10,0
940,2017-04-26,46,54,-8,0
941,2017-04-25,47,53,-6,0
942,2017-04-24,51,49,2,0
943,2017-04-21,49,51,-2,0
944,2017-04-20,49,51,-2,0
945,2017-04-19,48,52,-4,0
946,2017-04-18,50,50,0,0
947,2017-04-17,50,50,0,0
948,2017-04-14,48,52,-4,0
949,2017-04-13,48,52,-4,0
950,2017-04-12,47,53,-6,0
951,2017-04-11,47,53,-6,0
952,2017-04-10,44,56,-12,0
953,2017-04-07,45,55,-10,0
954,2017-04-06,46,54,-8,0
955,2017-04-05,46,54,-8,0
956,2017-04-04,43,57,-14,0
957,2017-04-03,42,58,-16,0
958,2017-03-31,43,57,-14,0
959,2017-03-30,44,56,-12,0
960,2017-03-29,44,56,-12,0
961,2017-03-28,45,55,-10,0
962,2017-03-27,45,54,-9,1
963,2017-03-24,44,56,-12,0
964,2017-03-23,47,53,-6,0
965,2017-03-22,46,54,-8,0
966,2017-03-21,50,50,0,0
967,2017-03-20,49,51,-2,0
968,2017-03-17,48,52,-4,0
969,2017-03-16,47,53,-6,0
970,2017-03-15,45,54,-9,1
971,2017-03-14,46,53,-7,1
972,2017-03-13,47,53,-6,0
973,2017-03-10,48,52,-4,0
974,2017-03-09,49,51,-2,0
975,2017-03-08,49,51,-2,0
976,2017-03-07,51,49,2,0
977,2017-03-06,52,48,4,0
978,2017-03-03,53,47,6,0
979,2017-03-02,52,48,4,0
980,2017-03-01,50,50,0,0
981,2017-02-28,50,50,0,0
982,2017-02-27,51,49,2,0
983,2017-02-24,53,47,6,0
984,2017-02-23,52,47,5,1
985,2017-02-22,51,49,2,0
986,2017-02-21,50,50,0,0
987,2017-02-20,51,49,2,0
988,2017-02-17,55,45,10,0
989,2017-02-16,55,45,10,0
990,2017-02-15,53,47,6,0
991,2017-02-14,52,48,4,0
992,2017-02-13,52,48,4,0
993,2017-02-10,52,48,4,0
994,2017-02-09,53,47,6,0
995,2017-02-08,53,47,6,0
996,2017-02-07,53,47,6,0
997,2017-02-06,53,47,6,0
998,2017-02-03,54,46,8,0
999,2017-02-02,53,47,6,0
1000,2017-02-01,53,47,6,0
1001,2017-01-31,51,49,2,0
1002,2017-01-30,53,47,6,0
1003,2017-01-27,55,45,10,0
1004,2017-01-26,59,41,18,0
1005,2017-01-25,57,43,14,0
1006,2017-01-24,57,43,14,0
1007,2017-01-23,55,44,11,1
1008,2017-01-20,56,44,12,0
